======================================================================
TOP 5 INTERACTIVE FICTION GAMES - WALKTHROUGH GENERATION
======================================================================
AI Mode: Claude (Anthropic)
Max iterations: 50
Timestamp: 2025-12-06T14:27:14.843702


======================================================================
GAME 1/5: Anchorhead (#2 in 2023 Top 50)
File: games/zcode/anchor.z8
======================================================================

STEP 1: Generating walkthrough with AI...
----------------------------------------------------------------------
Loading games/zcode/anchor.z8...
============================================================
GAME START
============================================================













                             A N C H O R H E A D


               [Press 'R' to restore; any other key to begin]
                                                                                              The oldest and strongest emotion of mankind                                               is fear, and the oldest and strongest kind                                               of fear is fear of the unknown.                                                                                              -- H.P. Lovecraft                                               [ The oldest and strongest emotion of mankind
  is fear, and the oldest and strongest kind
  of fear is fear of the unknown.
  
  -- H.P. Lovecraft]



Using Anthropic Claude for AI assistance...

============================================================
ITERATION 1
============================================================
Room: Class (ID: 1)
Inventory: empty
Exits: none
Objects: none

AI analyzing...
Priority: high
Puzzles detected: ["The player may need to figure out how to 'restore' the game, which could involve a puzzle or task."]
Suggested commands: ['look', 'examine', 'read', "press 'r'", 'inventory']

> look



November, 1997.


You take a deep breath of salty air as the first raindrops begin to spatter the pavement, and the swollen, slate-colored clouds that blanket the sky mutter ominous portents amongst themselves over the little coastal town of Anchorhead.

Squinting up into the glowering storm, you...
✓ Something interesting happened!

> examine
                                                                                                                          * THE FIRST DAY *                                                                                                          I was far from home, and the spell of the eastern      ...
✓ Something interesting happened!

> read




ANCHORHEAD
An interactive gothic by Michael S. Gentry

(Type HELP or ABOUT for some useful information.)

Release 5 / Serial number 990206 / Inform v6.15 Library 6/7

Outside the Real Estate Office
A grim little cul-de-sac, tucked away in a corner of the claustrophobic tangle of narrow, twisting...
✓ Something interesting happened!

> press 'r'
You can't see any such thing.

>Outside the Real Estate Officeday one
✓ Something interesting happened!

> inventory
You are wearing your wedding ring, your trenchcoat and your clothes; in addition, you have in your hand your umbrella.

The pockets of your trenchcoat are empty.

>Outside the Real Estate Officeday one
✓ Something interesting happened!

============================================================
ITERATION 2
============================================================
Room: Class (ID: 1)
Inventory: empty
Exits: none
Objects: none

AI analyzing...
Priority: medium
Puzzles detected: ['The sudden move to Anchorhead seems to be a mysterious event that the player is trying to understand.']
Suggested commands: ['look', 'examine room', 'examine umbrella', 'examine trenchcoat', 'go east']

> look

Outside the Real Estate Office
A grim little cul-de-sac, tucked away in a corner of the claustrophobic tangle of narrow, twisting avenues that largely constitute the older portion of Anchorhead. Like most of the streets in this city, it is ancient, shadowy, and leads essentially nowhere. The lane e...
✓ Something interesting happened!

> examine room
You can't see any such thing.

>Outside the Real Estate Officeday one
✓ Something interesting happened!

> examine umbrella
Olive green, with a hook-shaped handle. It's a handy little thing, when it rains. It's currently open.

In the distance, you can hear the lonesome keening of a train whistle drifting on the wind.

>Outside the Real Estate Officeday one
✓ Something interesting happened!

> examine trenchcoat
You bought this coat during your honeymoon in England; it's a genuine London Fog. In addition to looking very cool, it has several deep pockets in which you can fit just about anything.

>Outside the Real Estate Officeday one
✓ Something interesting happened!

> go east
(opening the real estate office door first)
It seems to be locked.

Overhead, the swollen clouds flicker ominously with a greenish haze of sheet lightning.

>Outside the Real Estate Officeday one

============================================================
ITERATION 3
============================================================
Room: Class (ID: 1)
Inventory: empty
Exits: none
Objects: none

AI analyzing...
Priority: high
Puzzles detected: ['The real estate office door is locked, suggesting a puzzle to be solved in order to gain access.']
Suggested commands: ['look', 'examine class', 'examine H.P. Lovecraft quote', 'examine exits']

> look
I didn't understand that sentence.

>Outside the Real Estate Officeday one
✓ Something interesting happened!

> examine class
You can't see any such thing.

>Outside the Real Estate Officeday one
✓ Something interesting happened!

> examine H.P. Lovecraft quote
You can't see any such thing.

>Outside the Real Estate Officeday one
✓ Something interesting happened!

> examine exits
You can't see any such thing.

>Outside the Real Estate Officeday one
✓ Something interesting happened!

============================================================
ITERATION 4
============================================================
Room: Class (ID: 1)
Inventory: empty
Exits: none
Objects: none

AI analyzing...
Priority: medium
Puzzles detected: ['The locked real estate office door seems to be an obstacle that needs to be resolved.']
Suggested commands: ['examine class', 'examine H.P. Lovecraft quote', 'examine exits', 'go north', 'go south']

> examine class
You can't see any such thing.

>Outside the Real Estate Officeday one
✓ Something interesting happened!

> examine H.P. Lovecraft quote
You can't see any such thing.

>Outside the Real Estate Officeday one
✓ Something interesting happened!

> examine exits
You can't see any such thing.

>Outside the Real Estate Officeday one
✓ Something interesting happened!

> go north
The street goes west from here. You can enter the office to the east or the alley to the southeast.

Overhead, the swollen clouds flicker ominously with a greenish haze of sheet lightning.

>Outside the Real Estate Officeday one
✓ Something interesting happened!

> go south
The street goes west from here. You can enter the office to the east or the alley to the southeast.

>Outside the Real Estate Officeday one
✓ Something interesting happened!

============================================================
ITERATION 5
============================================================
Room: Class (ID: 1)
Inventory: empty
Exits: none
Objects: none

AI analyzing...
Priority: medium
Puzzles detected: ['The game may require the player to explore the environment, discover clues, or solve challenges to progress.']
Suggested commands: ['examine quote', 'examine room', 'go east', 'go west', 'go southeast']

> examine quote
You can't see any such thing.

>Outside the Real Estate Officeday one
✓ Something interesting happened!

> examine room
You can't see any such thing.

>Outside the Real Estate Officeday one
✓ Something interesting happened!

> go east
(opening the real estate office door first)
It seems to be locked.

>Outside the Real Estate Officeday one

> go west
I didn't understand that sentence.

>Outside the Real Estate Officeday one
✓ Something interesting happened!

> go southeast

Alley
This narrow aperture between two buildings is nearly blocked with piles of rotting cardboard boxes and overstuffed garbage cans. Ugly, half-crumbling brick walls to either side totter oppressively over you. The alley ends here at a tall, wooden fence.

High up on the wall of the northern buil...

============================================================
ITERATION 6
============================================================
Room: Class (ID: 1)
Inventory: empty
Exits: none
Objects: none

AI analyzing...
Priority: high
Puzzles detected: ['The window may be a way to access a higher area, and the fence may block the way forward. The piles of boxes and garbage could contain useful items or hide a path.', 'The game may require the player to find a way to climb up or move the obstacles in the alley.']
Suggested commands: ['look', 'examine window', 'examine fence', 'examine boxes', 'examine garbage cans']

> look
I beg your pardon?

>Outside the Real Estate Officeday one
✓ Something interesting happened!

> examine window
You can't see any such thing.

>Outside the Real Estate Officeday one
✓ Something interesting happened!

> examine fence
You can't see any such thing.

>Outside the Real Estate Officeday one
✓ Something interesting happened!

> examine boxes
You can't see any such thing.

>Outside the Real Estate Officeday one
✓ Something interesting happened!

> examine garbage cans
You can't see any such thing.

>Outside the Real Estate Officeday one
✓ Something interesting happened!

============================================================
ITERATION 7
============================================================
Room: Class (ID: 1)
Inventory: empty
Exits: none
Objects: none

AI analyzing...
Priority: medium
Puzzles detected: ['The game may require the player to start or restore the game in order to progress.']
Suggested commands: ['look', 'examine room', 'read', 'restore']

> look

Outside the Real Estate Office
A grim little cul-de-sac, tucked away in a corner of the claustrophobic tangle of narrow, twisting avenues that largely constitute the older portion of Anchorhead. Like most of the streets in this city, it is ancient, shadowy, and leads essentially nowhere. The lane e...
✓ Something interesting happened!

> examine room
You can't see any such thing.

>Outside the Real Estate Officeday one
✓ Something interesting happened!

> read
(the sky)
How optimistic of you.

>Outside the Real Estate Officeday one
✓ Something interesting happened!

> restore
Restore failed.

>Outside the Real Estate Officeday one
✓ Something interesting happened!

============================================================
ITERATION 8
============================================================
Room: Class (ID: 1)
Inventory: empty
Exits: none
Objects: none

AI analyzing...
Priority: high
Puzzles detected: ['The restore command failed, suggesting there may be a problem with saving/restoring the game state that the player will need to figure out.', "The description mentions a 'claustrophobic tangle of narrow, twisting avenues', which may indicate a maze-like environment that the player will need to navigate."]
Suggested commands: ['look', 'examine', 'go east', 'go west', 'go southeast']

> look

Outside the Real Estate Office
A grim little cul-de-sac, tucked away in a corner of the claustrophobic tangle of narrow, twisting avenues that largely constitute the older portion of Anchorhead. Like most of the streets in this city, it is ancient, shadowy, and leads essentially nowhere. The lane e...
✓ Something interesting happened!

> examine
(the sky)
The sky is an unbroken blanket of seething gray clouds in every direction.

>Outside the Real Estate Officeday one
✓ Something interesting happened!

> go east
(opening the real estate office door first)
It seems to be locked.

>Outside the Real Estate Officeday one

> go west
I didn't understand that sentence.

>Outside the Real Estate Officeday one
✓ Something interesting happened!

> go southeast

Alley
This narrow aperture between two buildings is nearly blocked with piles of rotting cardboard boxes and overstuffed garbage cans. Ugly, half-crumbling brick walls to either side totter oppressively over you. The alley ends here at a tall, wooden fence.

High up on the wall of the northern buil...

============================================================
ITERATION 9
============================================================
Room: Class (ID: 1)
Inventory: empty
Exits: none
Objects: none

AI analyzing...
Priority: high
Puzzles detected: ['How to get past the locked door?', 'How to reach the window?', 'How to clear the alley?']
Suggested commands: ['examine window', 'examine fence', 'examine garbage', 'take object', 'open door']

> examine window
I beg your pardon?

>Outside the Real Estate Officeday one
✓ Something interesting happened!

> examine fence
You can't see any such thing.

>Outside the Real Estate Officeday one
✓ Something interesting happened!

> examine garbage
You can't see any such thing.

>Outside the Real Estate Officeday one
✓ Something interesting happened!

> take object
You can't see any such thing.

>Outside the Real Estate Officeday one
✓ Something interesting happened!

> open door
It seems to be locked.

>Outside the Real Estate Officeday one

============================================================
ITERATION 10
============================================================
Room: Class (ID: 1)
Inventory: empty
Exits: none
Objects: none

AI analyzing...
Priority: high
Puzzles detected: ['The locked door suggests there may be a puzzle or obstacle to overcome in order to progress.']
Suggested commands: ['look', 'examine', 'north', 'south', 'east', 'west']

> look
I didn't understand that sentence.

>Outside the Real Estate Officeday one
✓ Something interesting happened!

> examine
(the sky)
The sky is an unbroken blanket of seething gray clouds in every direction.

>Outside the Real Estate Officeday one
✓ Something interesting happened!

> north
The street goes west from here. You can enter the office to the east or the alley to the southeast.

>Outside the Real Estate Officeday one
✓ Something interesting happened!

> south
The street goes west from here. You can enter the office to the east or the alley to the southeast.

>Outside the Real Estate Officeday one
✓ Something interesting happened!

> east
(opening the real estate office door first)
It seems to be locked.

>Outside the Real Estate Officeday one

============================================================
ITERATION 11
============================================================
Room: Class (ID: 1)
Inventory: empty
Exits: none
Objects: none

AI analyzing...
Priority: medium
Puzzles detected: ['The door to the east appears to be locked, suggesting the player may need to find a way to unlock it.']
Suggested commands: ['look', 'examine', 'north', 'south', 'east', 'west']

> look
I didn't understand that sentence.

>Outside the Real Estate Officeday one
✓ Something interesting happened!

> examine
(the sky)
The sky is an unbroken blanket of seething gray clouds in every direction.

>Outside the Real Estate Officeday one
✓ Something interesting happened!

> north
The street goes west from here. You can enter the office to the east or the alley to the southeast.

>Outside the Real Estate Officeday one
✓ Something interesting happened!

> south
The street goes west from here. You can enter the office to the east or the alley to the southeast.

>Outside the Real Estate Officeday one
✓ Something interesting happened!

> east
(opening the real estate office door first)
It seems to be locked.

>Outside the Real Estate Officeday one

============================================================
ITERATION 12
============================================================
Room: Class (ID: 1)
Inventory: empty
Exits: none
Objects: none

AI analyzing...
Priority: high
Puzzles detected: ['The locked real estate office door suggests a puzzle or obstacle to overcome.']
Suggested commands: ['look', 'examine class', 'examine lovecraft quote', 'r']

> look
I didn't understand that sentence.

>Outside the Real Estate Officeday one
✓ Something interesting happened!

> examine class
You can't see any such thing.

>Outside the Real Estate Officeday one
✓ Something interesting happened!

> examine lovecraft quote
You can't see any such thing.

>Outside the Real Estate Officeday one
✓ Something interesting happened!

> r
That's not a verb I recognise.

>Outside the Real Estate Officeday one
✓ Something interesting happened!

============================================================
ITERATION 13
============================================================
Room: Class (ID: 1)
Inventory: empty
Exits: none
Objects: none

AI analyzing...
Priority: medium
Puzzles detected: ['Unlocking the door to the east']
Suggested commands: ['look', 'examine', 'read', 'open door', 'north']

> look

Outside the Real Estate Office
A grim little cul-de-sac, tucked away in a corner of the claustrophobic tangle of narrow, twisting avenues that largely constitute the older portion of Anchorhead. Like most of the streets in this city, it is ancient, shadowy, and leads essentially nowhere. The lane e...
✓ Something interesting happened!

> examine
(the sky)
The sky is an unbroken blanket of seething gray clouds in every direction.

>Outside the Real Estate Officeday one
✓ Something interesting happened!

> read
(the sky)
How optimistic of you.

>Outside the Real Estate Officeday one
✓ Something interesting happened!

> open door
It seems to be locked.

>Outside the Real Estate Officeday one

> north
I didn't understand that sentence.

>Outside the Real Estate Officeday one
✓ Something interesting happened!

============================================================
ITERATION 14
============================================================
Room: Class (ID: 1)
Inventory: empty
Exits: none
Objects: none

AI analyzing...
Priority: high
Puzzles detected: ['The door to the east is locked, so the player may need to find a way to unlock it.']
Suggested commands: ['look', 'examine', 'go east', 'go west', 'go southeast']

> look

Outside the Real Estate Office
A grim little cul-de-sac, tucked away in a corner of the claustrophobic tangle of narrow, twisting avenues that largely constitute the older portion of Anchorhead. Like most of the streets in this city, it is ancient, shadowy, and leads essentially nowhere. The lane e...
✓ Something interesting happened!

> examine
(the sky)
The sky is an unbroken blanket of seething gray clouds in every direction.

The rain slackens off momentarily to a weak drizzle, then returns afresh in a brief, freezing downpour.

>Outside the Real Estate Officeday one
✓ Something interesting happened!

> go east
(opening the real estate office door first)
It seems to be locked.

>Outside the Real Estate Officeday one

> go west
I didn't understand that sentence.

>Outside the Real Estate Officeday one
✓ Something interesting happened!

> go southeast

Alley
This narrow aperture between two buildings is nearly blocked with piles of rotting cardboard boxes and overstuffed garbage cans. Ugly, half-crumbling brick walls to either side totter oppressively over you. The alley ends here at a tall, wooden fence.

High up on the wall of the northern buil...

============================================================
ITERATION 15
============================================================
Room: Class (ID: 1)
Inventory: empty
Exits: none
Objects: none

AI analyzing...
Priority: medium
Puzzles detected: ['How to get through the tall, wooden fence at the end of the alley']
Suggested commands: ['look', 'examine window', 'examine fence', 'go west']

> look
I beg your pardon?

>Outside the Real Estate Officeday one
✓ Something interesting happened!

> examine window
You can't see any such thing.

>Outside the Real Estate Officeday one
✓ Something interesting happened!

> examine fence
You can't see any such thing.

>Outside the Real Estate Officeday one
✓ Something interesting happened!

> go west

Narrow Street
As the lane winds along from east to west, it narrows until the steep, jagged rooftops on either side of the street practically touch each other. To the south, a side street leads across Whateley Bridge toward the center of town, and a twisting lane leads up a hill to the northwest. A...
✓ Something interesting happened!

============================================================
ITERATION 16
============================================================
Room: Class (ID: 1)
Inventory: empty
Exits: none
Objects: none

AI analyzing...
Priority: high
Puzzles detected: ['The narrow alley and obstacles in the way suggest there may be a puzzle or challenge to overcome in order to proceed further.']
Suggested commands: ['look', 'examine window', 'examine fence', 'go west']

> look

Narrow Street
As the lane winds along from east to west, it narrows until the steep, jagged rooftops on either side of the street practically touch each other. To the south, a side street leads across Whateley Bridge toward the center of town, and a twisting lane leads up a hill to the northwest. A...
✓ Something interesting happened!

> examine window
You can't see any such thing.

>Narrow Streetday one
✓ Something interesting happened!

> examine fence
You can't see any such thing.

>Narrow Streetday one
✓ Something interesting happened!

> go west

Junction
To the north, a gap in the crowded press of gloomy buildings opens onto a country lane, heading out over a grassy heath. The main street continues to the east, while to the northwest, over the top of a steep rise, you can just make out the vaulted rooftops of the university.

>Junctionday ...
✓ Something interesting happened!

============================================================
ITERATION 17
============================================================
Room: Class (ID: 1)
Inventory: empty
Exits: none
Objects: none

AI analyzing...
Priority: medium
Suggested commands: ['look', 'examine window', 'examine fence', 'go north', 'go south']

> look

Junction
To the north, a gap in the crowded press of gloomy buildings opens onto a country lane, heading out over a grassy heath. The main street continues to the east, while to the northwest, over the top of a steep rise, you can just make out the vaulted rooftops of the university.

>Junctionday ...
✓ Something interesting happened!

> examine window
You can't see any such thing.

>Junctionday one

> examine fence
You can't see any such thing.

>Junctionday one

> go north

Mill Road
The road carries you across a desolate heath of gray, windswept grass. To the south, the black, jagged outline of Anchorhead's steep roofs and sharp, leaning gables cuts across the horizon. The road forks here to the west and east, heading across the railroad tracks in one direction, out ...
✓ Something interesting happened!

> go south

Junction
To the north, a gap in the crowded press of gloomy buildings opens onto a country lane, heading out over a grassy heath. The main street continues to the east, while to the northwest, over the top of a steep rise, you can just make out the vaulted rooftops of the university.

>Junctionday ...
✓ Something interesting happened!

============================================================
ITERATION 18
============================================================
Room: Class (ID: 1)
Inventory: empty
Exits: none
Objects: none

AI analyzing...
Priority: high
Suggested commands: ['examine room', 'examine class', 'look', 'go east', 'go northwest']

> examine room
You can't see any such thing.

>Junctionday one

> examine class
You can't see any such thing.

>Junctionday one

> look

Junction
To the north, a gap in the crowded press of gloomy buildings opens onto a country lane, heading out over a grassy heath. The main street continues to the east, while to the northwest, over the top of a steep rise, you can just make out the vaulted rooftops of the university.

>Junctionday ...
✓ Something interesting happened!

> go east

Narrow Street
As the lane winds along from east to west, it narrows until the steep, jagged rooftops on either side of the street practically touch each other. To the south, a side street leads across Whateley Bridge toward the center of town, and a twisting lane leads up a hill to the northwest. A...
✓ Something interesting happened!

> go northwest

Twisting Lane
The lane narrows here to little more than a badly cobbled sidewalk as it wends its way up through a series of tortuous bends and switchbacks. In some places, the street is so steep that steps have been cut into it, worn down over the years and slick with moss. Your progress is blocked...

============================================================
ITERATION 19
============================================================
Room: Class (ID: 1)
Inventory: empty
Exits: none
Objects: none

AI analyzing...
Priority: medium
Suggested commands: ['look', 'examine class', 'examine room', 'go north', 'go east']

> look
I didn't understand that sentence.

>Narrow Streetday one
✓ Something interesting happened!

> examine class
You can't see any such thing.

>Narrow Streetday one
✓ Something interesting happened!

> examine room
You can't see any such thing.

>Narrow Streetday one
✓ Something interesting happened!

> go north
You close your umbrella, as is your habit after coming indoors.

Local Pub
A dank, drafty old drinking hole lit by flickering, oil-burning lanterns. Smoke collects in greasy pools among the rafters, and shadows crowd thick around. The bar runs the length of the room to your right, while to the south...

> go east
I didn't understand that sentence.

>Narrow Streetday one
✓ Something interesting happened!

============================================================
ITERATION 20
============================================================
Room: Class (ID: 1)
Inventory: empty
Exits: none
Objects: none

AI analyzing...
Priority: high
Puzzles detected: ["The reason for being in the 'Class' room and the significance of the Lovecraft quote are not yet clear, suggesting a puzzle or mystery to uncover."]
Suggested commands: ['look', 'examine room', 'examine class', 'go south', 'go north']

> look

Narrow Street
As the lane winds along from east to west, it narrows until the steep, jagged rooftops on either side of the street practically touch each other. To the south, a side street leads across Whateley Bridge toward the center of town, and a twisting lane leads up a hill to the northwest. A...
✓ Something interesting happened!

> examine room
You can't see any such thing.

>Narrow Streetday one
✓ Something interesting happened!

> examine class
You can't see any such thing.

>Narrow Streetday one
✓ Something interesting happened!

> go south

Whateley Bridge
A hoary monument of crumbling, moss-eaten flagstones, Whateley Bridge is possibly older than any other structure in the entire city. Ponderously it spans the dark, torpid waters of the Miskaton River, connecting the north and south halves of the city and occasionally raining bits of...
✓ Something interesting happened!

> go north

Narrow Street
As the lane winds along from east to west, it narrows until the steep, jagged rooftops on either side of the street practically touch each other. To the south, a side street leads across Whateley Bridge toward the center of town, and a twisting lane leads up a hill to the northwest. A...
✓ Something interesting happened!

============================================================
ITERATION 21
============================================================
Room: Class (ID: 1)
Inventory: empty
Exits: none
Objects: none

AI analyzing...
Priority: medium
Puzzles detected: ["Accessing the 'Class' room or finding a way to progress the story"]
Suggested commands: ['look', 'examine class', 'go north', 'go south', 'examine bridge']

> look

Narrow Street
As the lane winds along from east to west, it narrows until the steep, jagged rooftops on either side of the street practically touch each other. To the south, a side street leads across Whateley Bridge toward the center of town, and a twisting lane leads up a hill to the northwest. A...
✓ Something interesting happened!

> examine class
You can't see any such thing.

>Narrow Streetday one
✓ Something interesting happened!

> go north
You close your umbrella, as is your habit after coming indoors.

Local Pub
A dank, drafty old drinking hole lit by flickering, oil-burning lanterns. Smoke collects in greasy pools among the rafters, and shadows crowd thick around. The bar runs the length of the room to your right, while to the south...

> go south
I didn't understand that sentence.

>Narrow Streetday one
✓ Something interesting happened!

> examine bridge
Old Whateley Bridge spans the river to the south.

>Narrow Streetday one
✓ Something interesting happened!

============================================================
ITERATION 22
============================================================
Room: Class (ID: 1)
Inventory: empty
Exits: none
Objects: none

AI analyzing...
Priority: medium
Puzzles detected: ["The reason for the player being in the 'Class' room is unclear, and the description mentions fear of the unknown, suggesting there may be a mystery or puzzle to solve."]
Suggested commands: ['look', 'examine class', 'examine bridge', 'go south', 'go north']

> look

Narrow Street
As the lane winds along from east to west, it narrows until the steep, jagged rooftops on either side of the street practically touch each other. To the south, a side street leads across Whateley Bridge toward the center of town, and a twisting lane leads up a hill to the northwest. A...
✓ Something interesting happened!

> examine class
You can't see any such thing.

>Narrow Streetday one
✓ Something interesting happened!

> examine bridge
Old Whateley Bridge spans the river to the south.

>Narrow Streetday one
✓ Something interesting happened!

> go south

Whateley Bridge
A hoary monument of crumbling, moss-eaten flagstones, Whateley Bridge is possibly older than any other structure in the entire city. Ponderously it spans the dark, torpid waters of the Miskaton River, connecting the north and south halves of the city and occasionally raining bits of...
✓ Something interesting happened!

> go north

Narrow Street
As the lane winds along from east to west, it narrows until the steep, jagged rooftops on either side of the street practically touch each other. To the south, a side street leads across Whateley Bridge toward the center of town, and a twisting lane leads up a hill to the northwest. A...
✓ Something interesting happened!

============================================================
ITERATION 23
============================================================
Room: Class (ID: 1)
Inventory: empty
Exits: none
Objects: none

AI analyzing...
Priority: medium
Puzzles detected: ["Exploring the town and finding a way to access the 'Class' room"]
Suggested commands: ['examine class', 'examine bridge', 'go north', 'go south']

> examine class
You can't see any such thing.

>Narrow Streetday one
✓ Something interesting happened!

> examine bridge
Old Whateley Bridge spans the river to the south.

>Narrow Streetday one
✓ Something interesting happened!

> go north
You close your umbrella, as is your habit after coming indoors.

Local Pub
A dank, drafty old drinking hole lit by flickering, oil-burning lanterns. Smoke collects in greasy pools among the rafters, and shadows crowd thick around. The bar runs the length of the room to your right, while to the south...

> go south
I didn't understand that sentence.

>Narrow Streetday one
✓ Something interesting happened!

============================================================
ITERATION 24
============================================================
Room: Class (ID: 1)
Inventory: empty
Exits: none
Objects: none

AI analyzing...
Priority: high
Puzzles detected: ['The reason for being in the classroom and the significance of the Lovecraft quote are unclear, so there may be a puzzle or mystery to uncover.']
Suggested commands: ['go north', 'examine bridge', 'examine pub', 'take inventory', 'examine lantern']

> go north
You close your umbrella, as is your habit after coming indoors.

Local Pub
A dank, drafty old drinking hole lit by flickering, oil-burning lanterns. Smoke collects in greasy pools among the rafters, and shadows crowd thick around. The bar runs the length of the room to your right, while to the south...

> examine bridge
I beg your pardon?

>Narrow Streetday one

> examine pub
You needn't worry about that.

>Narrow Streetday one
✓ Something interesting happened!

> take inventory
You are wearing your wedding ring, your trenchcoat and your clothes; in addition, you have in your hand your umbrella.

The pockets of your trenchcoat are empty.

>Narrow Streetday one
✓ Something interesting happened!

> examine lantern
You can't see any such thing.

>Narrow Streetday one
✓ Something interesting happened!

============================================================
ITERATION 25
============================================================
Room: Class (ID: 1)
Inventory: empty
Exits: none
Objects: none

AI analyzing...
Priority: medium
Suggested commands: ['examine class', 'examine umbrella', 'look', 'inventory', 'go south']

> examine class
You can't see any such thing.

>Narrow Streetday one
✓ Something interesting happened!

> examine umbrella
Olive green, with a hook-shaped handle. It's a handy little thing, when it rains. It's currently open.

>Narrow Streetday one
✓ Something interesting happened!

> look

Narrow Street
As the lane winds along from east to west, it narrows until the steep, jagged rooftops on either side of the street practically touch each other. To the south, a side street leads across Whateley Bridge toward the center of town, and a twisting lane leads up a hill to the northwest. A...
✓ Something interesting happened!

> inventory
You are wearing your wedding ring, your trenchcoat and your clothes; in addition, you have in your hand your umbrella.

The pockets of your trenchcoat are empty.

>Narrow Streetday one
✓ Something interesting happened!

> go south

Whateley Bridge
A hoary monument of crumbling, moss-eaten flagstones, Whateley Bridge is possibly older than any other structure in the entire city. Ponderously it spans the dark, torpid waters of the Miskaton River, connecting the north and south halves of the city and occasionally raining bits of...
✓ Something interesting happened!

============================================================
ITERATION 26
============================================================
Room: Class (ID: 1)
Inventory: empty
Exits: none
Objects: none

AI analyzing...
Priority: high
Puzzles detected: ['The player may need to figure out how to start or restore the game.']
Suggested commands: ['look', 'examine class', 'read', 'go north', 'go south']

> look

Whateley Bridge
A hoary monument of crumbling, moss-eaten flagstones, Whateley Bridge is possibly older than any other structure in the entire city. Ponderously it spans the dark, torpid waters of the Miskaton River, connecting the north and south halves of the city and occasionally raining bits of...
✓ Something interesting happened!

> examine class
You can't see any such thing.

>Whateley Bridgeday one
✓ Something interesting happened!

> read
(the sky)
How optimistic of you.

>Whateley Bridgeday one
✓ Something interesting happened!

> go north

Narrow Street
As the lane winds along from east to west, it narrows until the steep, jagged rooftops on either side of the street practically touch each other. To the south, a side street leads across Whateley Bridge toward the center of town, and a twisting lane leads up a hill to the northwest. A...
✓ Something interesting happened!

> go south

Whateley Bridge
A hoary monument of crumbling, moss-eaten flagstones, Whateley Bridge is possibly older than any other structure in the entire city. Ponderously it spans the dark, torpid waters of the Miskaton River, connecting the north and south halves of the city and occasionally raining bits of...
✓ Something interesting happened!

============================================================
ITERATION 27
============================================================
Room: Class (ID: 1)
Inventory: empty
Exits: none
Objects: none

AI analyzing...
Priority: high
Puzzles detected: ['The game may present challenges or obstacles related to navigating the environment or uncovering the mystery behind the Lovecraft-inspired setting.']
Suggested commands: ['look', 'examine class', 'examine whateley bridge', 'go north', 'go south']

> look

Whateley Bridge
A hoary monument of crumbling, moss-eaten flagstones, Whateley Bridge is possibly older than any other structure in the entire city. Ponderously it spans the dark, torpid waters of the Miskaton River, connecting the north and south halves of the city and occasionally raining bits of...
✓ Something interesting happened!

> examine class
You can't see any such thing.

>Whateley Bridgeday one
✓ Something interesting happened!

> examine whateley bridge
You can't see any such thing.

>Whateley Bridgeday one
✓ Something interesting happened!

> go north

Narrow Street
As the lane winds along from east to west, it narrows until the steep, jagged rooftops on either side of the street practically touch each other. To the south, a side street leads across Whateley Bridge toward the center of town, and a twisting lane leads up a hill to the northwest. A...
✓ Something interesting happened!

> go south

Whateley Bridge
A hoary monument of crumbling, moss-eaten flagstones, Whateley Bridge is possibly older than any other structure in the entire city. Ponderously it spans the dark, torpid waters of the Miskaton River, connecting the north and south halves of the city and occasionally raining bits of...
✓ Something interesting happened!

============================================================
ITERATION 28
============================================================
Room: Class (ID: 1)
Inventory: empty
Exits: none
Objects: none

AI analyzing...
Priority: medium
Puzzles detected: ['Crossing the Whateley Bridge might present some kind of challenge or obstacle.']
Suggested commands: ['examine whateley bridge', 'go north', 'go down']

> examine whateley bridge
You can't see any such thing.

>Whateley Bridgeday one
✓ Something interesting happened!

> go north

Narrow Street
As the lane winds along from east to west, it narrows until the steep, jagged rooftops on either side of the street practically touch each other. To the south, a side street leads across Whateley Bridge toward the center of town, and a twisting lane leads up a hill to the northwest. A...
✓ Something interesting happened!

> go down
You close your umbrella, as is your habit after coming indoors.

Local Pub
A dank, drafty old drinking hole lit by flickering, oil-burning lanterns. Smoke collects in greasy pools among the rafters, and shadows crowd thick around. The bar runs the length of the room to your right, while to the south...

============================================================
ITERATION 29
============================================================
Room: Class (ID: 1)
Inventory: empty
Exits: none
Objects: none

AI analyzing...
Priority: medium
Puzzles detected: ['The lantern seems to be sputtering, which could indicate a problem to be solved.', "The general atmosphere of the pub, described as 'dank, drafty' and 'dreary fatalism', suggests that there may be a larger mystery or challenge to uncover."]
Suggested commands: ['examine lantern', 'examine table', 'examine bar', 'talk to mill workers', 'talk to fishermen']

> examine lantern
I didn't understand that sentence.

>Narrow Streetday one
✓ Something interesting happened!

> examine table
You can't see any such thing.

>Narrow Streetday one
✓ Something interesting happened!

> examine bar
You can't see any such thing.

>Narrow Streetday one
✓ Something interesting happened!

> talk to mill workers
You can't see any such thing.

>Narrow Streetday one
✓ Something interesting happened!

> talk to fishermen
You can't see any such thing.

>Narrow Streetday one
✓ Something interesting happened!

============================================================
ITERATION 30
============================================================
Room: Class (ID: 1)
Inventory: empty
Exits: none
Objects: none

AI analyzing...
Priority: high
Puzzles detected: ['None apparent yet']
Suggested commands: ['examine', 'look', 'go']

> examine
(the sky)
The sky is an unbroken blanket of seething gray clouds in every direction.

In the distance, you can hear the lonesome keening of a train whistle drifting on the wind.

>Narrow Streetday one
✓ Something interesting happened!

> look

Narrow Street
As the lane winds along from east to west, it narrows until the steep, jagged rooftops on either side of the street practically touch each other. To the south, a side street leads across Whateley Bridge toward the center of town, and a twisting lane leads up a hill to the northwest. A...
✓ Something interesting happened!

> go
You'll have to specify a direction.

Overhead, the swollen clouds flicker ominously with a greenish haze of sheet lightning.

>Narrow Streetday one
✓ Something interesting happened!

============================================================
ITERATION 31
============================================================
Room: Class (ID: 1)
Inventory: empty
Exits: none
Objects: none

AI analyzing...
Priority: medium
Puzzles detected: ["The mention of the 'greenish haze of sheet lightning' in the sky could potentially be a clue to some kind of weather-related puzzle."]
Suggested commands: ['go north', 'go south', 'go east', 'go west', 'examine sky']

> go north
You close your umbrella, as is your habit after coming indoors.

Local Pub
A dank, drafty old drinking hole lit by flickering, oil-burning lanterns. Smoke collects in greasy pools among the rafters, and shadows crowd thick around. The bar runs the length of the room to your right, while to the south...

> go south
I didn't understand that sentence.

>Narrow Streetday one
✓ Something interesting happened!

> go east

Outside the Real Estate Office
A grim little cul-de-sac, tucked away in a corner of the claustrophobic tangle of narrow, twisting avenues that largely constitute the older portion of Anchorhead. Like most of the streets in this city, it is ancient, shadowy, and leads essentially nowhere. The lane e...
✓ Something interesting happened!

> go west

Narrow Street
As the lane winds along from east to west, it narrows until the steep, jagged rooftops on either side of the street practically touch each other. To the south, a side street leads across Whateley Bridge toward the center of town, and a twisting lane leads up a hill to the northwest. A...
✓ Something interesting happened!

> examine sky
The sky is an unbroken blanket of seething gray clouds in every direction.

>Narrow Streetday one
✓ Something interesting happened!

============================================================
ITERATION 32
============================================================
Room: Class (ID: 1)
Inventory: empty
Exits: none
Objects: none

AI analyzing...
Priority: medium
Puzzles detected: ["The description mentions a 'claustrophobic tangle of narrow, twisting avenues' and 'the oldest and strongest kind of fear is fear of the unknown', suggesting there may be a mystery or puzzle related to the environment or the town's history that the player needs to uncover.", 'The lack of visible objects and inventory could indicate that the player needs to find and interact with certain items to progress through the game.']
Suggested commands: ['examine', 'look', 'go north', 'go east', 'go west']

> examine
(the sky)
The sky is an unbroken blanket of seething gray clouds in every direction.

>Narrow Streetday one
✓ Something interesting happened!

> look

Narrow Street
As the lane winds along from east to west, it narrows until the steep, jagged rooftops on either side of the street practically touch each other. To the south, a side street leads across Whateley Bridge toward the center of town, and a twisting lane leads up a hill to the northwest. A...
✓ Something interesting happened!

> go north
You close your umbrella, as is your habit after coming indoors.

Local Pub
A dank, drafty old drinking hole lit by flickering, oil-burning lanterns. Smoke collects in greasy pools among the rafters, and shadows crowd thick around. The bar runs the length of the room to your right, while to the south...

> go east
I didn't understand that sentence.

>Narrow Streetday one
✓ Something interesting happened!

> go west

Junction
To the north, a gap in the crowded press of gloomy buildings opens onto a country lane, heading out over a grassy heath. The main street continues to the east, while to the northwest, over the top of a steep rise, you can just make out the vaulted rooftops of the university.

>Junctionday ...
✓ Something interesting happened!

============================================================
ITERATION 33
============================================================
Room: Class (ID: 1)
Inventory: empty
Exits: none
Objects: none

AI analyzing...
Priority: high
Puzzles detected: ["The game seems to have a mysterious and ominous tone, hinting at the 'fear of the unknown' theme. There may be some kind of puzzle or challenge related to this theme."]
Suggested commands: ['go north', 'go east', 'go west', 'examine class', 'examine narrow street', 'examine local pub', 'examine junction']

> go north

Mill Road
The road carries you across a desolate heath of gray, windswept grass. To the south, the black, jagged outline of Anchorhead's steep roofs and sharp, leaning gables cuts across the horizon. The road forks here to the west and east, heading across the railroad tracks in one direction, out ...
✓ Something interesting happened!

> go east
The road heads out over a narrow breakwater jutting out into the ocean.

Breakwater
You are picking your way across the breakwater's bare, rocky spine, where the road has diminished to little more than a pair of dusty ruts. A hundred yards to the northeast, at the breakwater's far end, the lonely st...
✓ Something interesting happened!

> go west

Mill Road
The road carries you across a desolate heath of gray, windswept grass. To the south, the black, jagged outline of Anchorhead's steep roofs and sharp, leaning gables cuts across the horizon. The road forks here to the west and east, heading across the railroad tracks in one direction, out ...
✓ Something interesting happened!

> examine class
You can't see any such thing.

>Mill Roadday one

> examine narrow street
You can't see any such thing.

>Mill Roadday one

============================================================
ITERATION 34
============================================================
Room: Class (ID: 1)
Inventory: empty
Exits: none
Objects: none

AI analyzing...
Priority: medium
Suggested commands: ['go west', 'go east', 'examine lighthouse', 'examine breakwater', 'inventory']

> go west
As you cross the railroad tracks, the air becomes warmer, more dingy, and slightly more difficult to breathe.

Entrance to the Paper Mill
The road turns southwest here and runs squarely through the front entrance to the old paper mill. A gate of heavy iron bars blocks the only opening into this char...

> go east
I didn't understand that sentence.

>Mill Roadday one
✓ Something interesting happened!

> examine lighthouse
The lighthouse stands tall against the horizon, a dingy white tower amidst a gray sky and a grayer sea. Despite the ominous cast to the weather, no beacon is shining from the tower's top.

>Mill Roadday one
✓ Something interesting happened!

> examine breakwater
You can't see any such thing.

>Mill Roadday one

> inventory
You are wearing your wedding ring, your trenchcoat and your clothes; in addition, you have in your hand your umbrella.

The pockets of your trenchcoat are empty.

>Mill Roadday one
✓ Something interesting happened!

============================================================
ITERATION 35
============================================================
Room: Class (ID: 1)
Inventory: empty
Exits: none
Objects: none

AI analyzing...
Priority: high
Puzzles detected: ['The gate blocking the entrance to the paper mill may be a puzzle that needs to be solved to progress.']
Suggested commands: ['examine class', 'examine lighthouse', 'go north', 'go south', 'inventory']

> examine class
You can't see any such thing.

>Mill Roadday one

> examine lighthouse
The lighthouse stands tall against the horizon, a dingy white tower amidst a gray sky and a grayer sea. Despite the ominous cast to the weather, no beacon is shining from the tower's top.

>Mill Roadday one
✓ Something interesting happened!

> go north
There's not much in that direction except the featureless, desolate heath.

The rain slackens off momentarily to a weak drizzle, then returns afresh in a brief, freezing downpour.

>Mill Roadday one
✓ Something interesting happened!

> go south

Junction
To the north, a gap in the crowded press of gloomy buildings opens onto a country lane, heading out over a grassy heath. The main street continues to the east, while to the northwest, over the top of a steep rise, you can just make out the vaulted rooftops of the university.

>Junctionday ...
✓ Something interesting happened!

> inventory
You are wearing your wedding ring, your trenchcoat and your clothes; in addition, you have in your hand your umbrella.

The pockets of your trenchcoat are empty.

>Junctionday one
✓ Something interesting happened!

============================================================
ITERATION 36
============================================================
Room: Class (ID: 1)
Inventory: empty
Exits: none
Objects: none

AI analyzing...
Priority: medium
Puzzles detected: ['The lack of a beacon in the lighthouse may indicate a puzzle or obstacle to be solved.']
Suggested commands: ['examine lighthouse', 'go north', 'go south', 'inventory']

> examine lighthouse
You can't see any such thing.

>Junctionday one

> go north

Mill Road
The road carries you across a desolate heath of gray, windswept grass. To the south, the black, jagged outline of Anchorhead's steep roofs and sharp, leaning gables cuts across the horizon. The road forks here to the west and east, heading across the railroad tracks in one direction, out ...
✓ Something interesting happened!

> go south

Junction
To the north, a gap in the crowded press of gloomy buildings opens onto a country lane, heading out over a grassy heath. The main street continues to the east, while to the northwest, over the top of a steep rise, you can just make out the vaulted rooftops of the university.

>Junctionday ...
✓ Something interesting happened!

> inventory
You are wearing your wedding ring, your trenchcoat and your clothes; in addition, you have in your hand your umbrella.

The pockets of your trenchcoat are empty.

>Junctionday one
✓ Something interesting happened!

============================================================
ITERATION 37
============================================================
Room: Class (ID: 1)
Inventory: empty
Exits: none
Objects: none

AI analyzing...
Priority: medium
Puzzles detected: ['The game may involve exploring the town of Anchorhead and uncovering its mysteries, which could lead to various puzzles or obstacles along the way.']
Suggested commands: ['go north', 'go east', 'examine lighthouse', 'examine university', 'examine rooftops']

> go north

Mill Road
The road carries you across a desolate heath of gray, windswept grass. To the south, the black, jagged outline of Anchorhead's steep roofs and sharp, leaning gables cuts across the horizon. The road forks here to the west and east, heading across the railroad tracks in one direction, out ...
✓ Something interesting happened!

> go east
The road heads out over a narrow breakwater jutting out into the ocean.

Breakwater
You are picking your way across the breakwater's bare, rocky spine, where the road has diminished to little more than a pair of dusty ruts. A hundred yards to the northeast, at the breakwater's far end, the lonely st...
✓ Something interesting happened!

> examine lighthouse
The lighthouse stands tall against the horizon, a dingy white tower amidst a gray sky and a grayer sea. Despite the ominous cast to the weather, no beacon is shining from the tower's top.

A sudden gust of wind blows a cold spray of rain into your face.

>Breakwaterday one
✓ Something interesting happened!

> examine university
You can't see any such thing.

>Breakwaterday one

> examine rooftops
You can't see any such thing.

>Breakwaterday one

============================================================
ITERATION 38
============================================================
Room: Class (ID: 1)
Inventory: empty
Exits: none
Objects: none

AI analyzing...
Priority: medium
Puzzles detected: ['The lack of a beacon in the lighthouse could be a puzzle to solve']
Suggested commands: ['examine lighthouse', 'examine rooftops', 'go west', 'go north', 'inventory']

> examine lighthouse
The lighthouse stands tall against the horizon, a dingy white tower amidst a gray sky and a grayer sea. Despite the ominous cast to the weather, no beacon is shining from the tower's top.

>Breakwaterday one
✓ Something interesting happened!

> examine rooftops
You can't see any such thing.

>Breakwaterday one

> go west

Mill Road
The road carries you across a desolate heath of gray, windswept grass. To the south, the black, jagged outline of Anchorhead's steep roofs and sharp, leaning gables cuts across the horizon. The road forks here to the west and east, heading across the railroad tracks in one direction, out ...
✓ Something interesting happened!

> go north
There's not much in that direction except the featureless, desolate heath.

>Mill Roadday one
✓ Something interesting happened!

> inventory
You are wearing your wedding ring, your trenchcoat and your clothes; in addition, you have in your hand your umbrella.

The pockets of your trenchcoat are empty.

>Mill Roadday one
✓ Something interesting happened!

============================================================
ITERATION 39
============================================================
Room: Class (ID: 1)
Inventory: empty
Exits: none
Objects: none

AI analyzing...
Priority: medium
Puzzles detected: ['The lighthouse is not functioning as it should, which could be a puzzle to solve.']
Suggested commands: ['examine class', 'examine lighthouse', 'go east', 'go west']

> examine class
You can't see any such thing.

>Mill Roadday one

> examine lighthouse
The lighthouse stands tall against the horizon, a dingy white tower amidst a gray sky and a grayer sea. Despite the ominous cast to the weather, no beacon is shining from the tower's top.

>Mill Roadday one
✓ Something interesting happened!

> go east
The road heads out over a narrow breakwater jutting out into the ocean.

Breakwater
You are picking your way across the breakwater's bare, rocky spine, where the road has diminished to little more than a pair of dusty ruts. A hundred yards to the northeast, at the breakwater's far end, the lonely st...
✓ Something interesting happened!

> go west

Mill Road
The road carries you across a desolate heath of gray, windswept grass. To the south, the black, jagged outline of Anchorhead's steep roofs and sharp, leaning gables cuts across the horizon. The road forks here to the west and east, heading across the railroad tracks in one direction, out ...
✓ Something interesting happened!

============================================================
ITERATION 40
============================================================
Room: Class (ID: 1)
Inventory: empty
Exits: none
Objects: none

AI analyzing...
Priority: medium
Puzzles detected: ['The reason the lighthouse beacon is not lit is unclear, which could be a potential puzzle to solve.']
Suggested commands: ['examine class', 'examine lighthouse', 'go east', 'inventory']

> examine class
You can't see any such thing.

>Mill Roadday one

> examine lighthouse
The lighthouse stands tall against the horizon, a dingy white tower amidst a gray sky and a grayer sea. Despite the ominous cast to the weather, no beacon is shining from the tower's top.

>Mill Roadday one
✓ Something interesting happened!

> go east
The road heads out over a narrow breakwater jutting out into the ocean.

Breakwater
You are picking your way across the breakwater's bare, rocky spine, where the road has diminished to little more than a pair of dusty ruts. A hundred yards to the northeast, at the breakwater's far end, the lonely st...
✓ Something interesting happened!

> inventory
You are wearing your wedding ring, your trenchcoat and your clothes; in addition, you have in your hand your umbrella.

The pockets of your trenchcoat are empty.

>Breakwaterday one
✓ Something interesting happened!

============================================================
ITERATION 41
============================================================
Room: Class (ID: 1)
Inventory: empty
Exits: none
Objects: none

AI analyzing...
Priority: medium
Puzzles detected: ['The game may have a puzzle or story that requires the player to investigate the lighthouse further.']
Suggested commands: ['examine class', 'examine lighthouse', 'go east']

> examine class
You can't see any such thing.

>Breakwaterday one

> examine lighthouse
The lighthouse stands tall against the horizon, a dingy white tower amidst a gray sky and a grayer sea. Despite the ominous cast to the weather, no beacon is shining from the tower's top.

>Breakwaterday one
✓ Something interesting happened!

> go east
The narrow breakwater is surrounded by ocean. You can only go west, back to shore; or northeast, to the lighthouse.

>Breakwaterday one
✓ Something interesting happened!

============================================================
ITERATION 42
============================================================
Room: Class (ID: 1)
Inventory: empty
Exits: none
Objects: none

AI analyzing...
Priority: medium
Puzzles detected: ['The reason why the lighthouse is not lit is unclear, which may be a puzzle to solve.']
Suggested commands: ['examine class', 'examine umbrella', 'examine trenchcoat', 'examine wedding ring', 'go northeast']

> examine class
You can't see any such thing.

>Breakwaterday one

> examine umbrella
Olive green, with a hook-shaped handle. It's a handy little thing, when it rains. It's currently open.

Another wave crashes against the rocks, sending a cloud of spray into the air.

A sudden gust of wind blows a cold spray of rain into your face.

>Breakwaterday one
✓ Something interesting happened!

> examine trenchcoat
You bought this coat during your honeymoon in England; it's a genuine London Fog. In addition to looking very cool, it has several deep pockets in which you can fit just about anything.

>Breakwaterday one
✓ Something interesting happened!

> examine wedding ring
Staring at your wedding ring like that tends to make you sentimental.

>Breakwaterday one
✓ Something interesting happened!

> go northeast

At the Foot of the Lighthouse
You stand in a circular clearing among the stones, surrounded on nearly every side by the sea. Before you looms the ancient, massive lighthouse, a vertiginous pillar of pale brick jabbing defiantly up at the sky. The road from the southwest ends here, although it looks...

============================================================
ITERATION 43
============================================================
Room: Class (ID: 1)
Inventory: empty
Exits: none
Objects: none

AI analyzing...
Priority: medium
Puzzles detected: ['Gaining access to the lighthouse, either by opening the door or finding an alternative way in']
Suggested commands: ['examine lighthouse', 'examine door', 'go southeast', 'inventory', 'examine ring']

> examine lighthouse
I didn't understand that sentence.

>Breakwaterday one
✓ Something interesting happened!

> examine door
You can't see any such thing.

>Breakwaterday one

> go southeast
The narrow breakwater is surrounded by ocean. You can only go west, back to shore; or northeast, to the lighthouse.

>Breakwaterday one
✓ Something interesting happened!

> inventory
You are wearing your wedding ring, your trenchcoat and your clothes; in addition, you have in your hand your umbrella.

The pockets of your trenchcoat are empty.

A sudden gust of wind blows a cold spray of rain into your face.

>Breakwaterday one
✓ Something interesting happened!

> examine ring
Staring at your wedding ring like that tends to make you sentimental.

>Breakwaterday one
✓ Something interesting happened!

============================================================
ITERATION 44
============================================================
Room: Class (ID: 1)
Inventory: empty
Exits: none
Objects: none

AI analyzing...
Priority: medium
Puzzles detected: ['Restoring the game state may be required to continue']
Suggested commands: ['examine class', 'examine description', 'examine exits', 'read text']

> examine class
You can't see any such thing.

>Breakwaterday one

> examine description
You can't see any such thing.

>Breakwaterday one

> examine exits
You can't see any such thing.

>Breakwaterday one

> read text
You can't see any such thing.

>Breakwaterday one

No interesting AI suggestions. Trying basic directions...

============================================================
ITERATION 45
============================================================
Room: Class (ID: 1)
Inventory: empty
Exits: none
Objects: none

AI analyzing...
Priority: high
Suggested commands: ['examine', 'search', 'take', 'inventory', 'look']

> examine
(the sky)
The sky is an unbroken blanket of seething gray clouds in every direction.

>Mill Roadday one
✓ Something interesting happened!

> search
(the sky)
The sky is an unbroken blanket of seething gray clouds in every direction.

>Mill Roadday one
✓ Something interesting happened!

> take
(the sky)
How optimistic of you.

In the distance, you can hear the lonesome keening of a train whistle drifting on the wind. You look to the west in time to see the train go by, rolling southwest past the mill toward less melancholy climes.

>Mill Roadday one
✓ Something interesting happened!

> inventory
You are wearing your wedding ring, your trenchcoat and your clothes; in addition, you have in your hand your umbrella.

The pockets of your trenchcoat are empty.

>Mill Roadday one
✓ Something interesting happened!

> look

Mill Road
The road carries you across a desolate heath of gray, windswept grass. To the south, the black, jagged outline of Anchorhead's steep roofs and sharp, leaning gables cuts across the horizon. The road forks here to the west and east, heading across the railroad tracks in one direction, out ...
✓ Something interesting happened!

============================================================
ITERATION 46
============================================================
Room: Class (ID: 1)
Inventory: empty
Exits: none
Objects: none

AI analyzing...
Priority: high
Puzzles detected: ['The game may involve uncovering the mystery or reason behind the desolate and ominous setting.']
Suggested commands: ['examine class', 'examine description', 'examine exits', 'examine objects', 'go west', 'go east']

> examine class
You can't see any such thing.

>Mill Roadday one

> examine description
You can't see any such thing.

>Mill Roadday one

> examine exits
You can't see any such thing.

>Mill Roadday one

> examine objects
You can't see any such thing.

>Mill Roadday one

> go west
As you cross the railroad tracks, the air becomes warmer, more dingy, and slightly more difficult to breathe.

Entrance to the Paper Mill
The road turns southwest here and runs squarely through the front entrance to the old paper mill. A gate of heavy iron bars blocks the only opening into this char...

No interesting AI suggestions. Trying basic directions...

============================================================
ITERATION 47
============================================================
Room: Class (ID: 1)
Inventory: empty
Exits: none
Objects: none

AI analyzing...
Priority: medium
Puzzles detected: ['The game may have more to explore beyond the initial room, so further investigation is needed to uncover any potential puzzles or obstacles.']
Suggested commands: ['examine room', 'examine description', 'look around', 'take inventory', 'examine exits']

> examine room
You can't see any such thing.

>Junctionday one

> examine description
You can't see any such thing.

>Junctionday one

> look around

Junction
To the north, a gap in the crowded press of gloomy buildings opens onto a country lane, heading out over a grassy heath. The main street continues to the east, while to the northwest, over the top of a steep rise, you can just make out the vaulted rooftops of the university.

>Junctionday ...
✓ Something interesting happened!

> take inventory
You are wearing your wedding ring, your trenchcoat and your clothes; in addition, you have in your hand your umbrella.

The pockets of your trenchcoat are empty.

>Junctionday one
✓ Something interesting happened!

> examine exits
You can't see any such thing.

>Junctionday one

============================================================
ITERATION 48
============================================================
Room: Class (ID: 1)
Inventory: empty
Exits: none
Objects: none

AI analyzing...
Priority: medium
Puzzles detected: ['The game may introduce puzzles or obstacles as the player progresses through the story.']
Suggested commands: ['look', 'examine class', 'examine description', 'examine exits', 'go north']

> look

Junction
To the north, a gap in the crowded press of gloomy buildings opens onto a country lane, heading out over a grassy heath. The main street continues to the east, while to the northwest, over the top of a steep rise, you can just make out the vaulted rooftops of the university.

>Junctionday ...
✓ Something interesting happened!

> examine class
You can't see any such thing.

>Junctionday one

> examine description
You can't see any such thing.

>Junctionday one

> examine exits
You can't see any such thing.

>Junctionday one

> go north

Mill Road
The road carries you across a desolate heath of gray, windswept grass. To the south, the black, jagged outline of Anchorhead's steep roofs and sharp, leaning gables cuts across the horizon. The road forks here to the west and east, heading across the railroad tracks in one direction, out ...
✓ Something interesting happened!

============================================================
ITERATION 49
============================================================
Room: Class (ID: 1)
Inventory: empty
Exits: none
Objects: none

AI analyzing...
Priority: high
Puzzles detected: ['None apparent at this stage']
Suggested commands: ['look', 'examine class', 'examine description', 'examine exits', 'go east', 'go west', 'examine mill road', 'examine heath', 'examine rooftops']

> look

Mill Road
The road carries you across a desolate heath of gray, windswept grass. To the south, the black, jagged outline of Anchorhead's steep roofs and sharp, leaning gables cuts across the horizon. The road forks here to the west and east, heading across the railroad tracks in one direction, out ...
✓ Something interesting happened!

> examine class
You can't see any such thing.

>Mill Roadday one

> examine description
You can't see any such thing.

>Mill Roadday one

> examine exits
You can't see any such thing.

>Mill Roadday one

> go east
The road heads out over a narrow breakwater jutting out into the ocean.

Breakwater
You are picking your way across the breakwater's bare, rocky spine, where the road has diminished to little more than a pair of dusty ruts. A hundred yards to the northeast, at the breakwater's far end, the lonely st...
✓ Something interesting happened!

============================================================
ITERATION 50
============================================================
Room: Class (ID: 1)
Inventory: empty
Exits: none
Objects: none

AI analyzing...
Priority: high
Suggested commands: ['look', 'examine class', 'examine description', 'examine exits', 'go west', 'go east']

> look

Breakwater
You are picking your way across the breakwater's bare, rocky spine, where the road has diminished to little more than a pair of dusty ruts. A hundred yards to the northeast, at the breakwater's far end, the lonely stone tower of Anchorhead's lighthouse stands vigil against the ocean.

>B...
✓ Something interesting happened!

> examine class
You can't see any such thing.

>Breakwaterday one

> examine description
You can't see any such thing.

>Breakwaterday one

> examine exits
You can't see any such thing.

>Breakwaterday one

> go west

Mill Road
The road carries you across a desolate heath of gray, windswept grass. To the south, the black, jagged outline of Anchorhead's steep roofs and sharp, leaning gables cuts across the horizon. The road forks here to the west and east, heading across the railroad tracks in one direction, out ...
✓ Something interesting happened!

============================================================
SOLUTION SUMMARY
============================================================
Rooms discovered: 1
Commands in solution: 174

Solution path:
  1. look
  2. examine
  3. read
  4. press 'r'
  5. inventory
  6. look
  7. examine room
  8. examine umbrella
  9. examine trenchcoat
  10. look
  11. examine class
  12. examine H.P. Lovecraft quote
  13. examine exits
  14. examine class
  15. examine H.P. Lovecraft quote
  16. examine exits
  17. go north
  18. go south
  19. examine quote
  20. examine room
  21. go west
  22. look
  23. examine window
  24. examine fence
  25. examine boxes
  26. examine garbage cans
  27. look
  28. examine room
  29. read
  30. restore
  31. look
  32. examine
  33. go west
  34. examine window
  35. examine fence
  36. examine garbage
  37. take object
  38. look
  39. examine
  40. north
  41. south
  42. look
  43. examine
  44. north
  45. south
  46. look
  47. examine class
  48. examine lovecraft quote
  49. r
  50. look
  51. examine
  52. read
  53. north
  54. look
  55. examine
  56. go west
  57. look
  58. examine window
  59. examine fence
  60. go west
  61. look
  62. examine window
  63. examine fence
  64. go west
  65. look
  66. go north
  67. go south
  68. look
  69. go east
  70. look
  71. examine class
  72. examine room
  73. go east
  74. look
  75. examine room
  76. examine class
  77. go south
  78. go north
  79. look
  80. examine class
  81. go south
  82. examine bridge
  83. look
  84. examine class
  85. examine bridge
  86. go south
  87. go north
  88. examine class
  89. examine bridge
  90. go south
  91. examine pub
  92. take inventory
  93. examine lantern
  94. examine class
  95. examine umbrella
  96. look
  97. inventory
  98. go south
  99. look
  100. examine class
  101. read
  102. go north
  103. go south
  104. look
  105. examine class
  106. examine whateley bridge
  107. go north
  108. go south
  109. examine whateley bridge
  110. go north
  111. examine lantern
  112. examine table
  113. examine bar
  114. talk to mill workers
  115. talk to fishermen
  116. examine
  117. look
  118. go
  119. go south
  120. go east
  121. go west
  122. examine sky
  123. examine
  124. look
  125. go east
  126. go west
  127. go north
  128. go east
  129. go west
  130. go east
  131. examine lighthouse
  132. inventory
  133. examine lighthouse
  134. go north
  135. go south
  136. inventory
  137. go north
  138. go south
  139. inventory
  140. go north
  141. go east
  142. examine lighthouse
  143. examine lighthouse
  144. go west
  145. go north
  146. inventory
  147. examine lighthouse
  148. go east
  149. go west
  150. examine lighthouse
  151. go east
  152. inventory
  153. examine lighthouse
  154. go east
  155. examine umbrella
  156. examine trenchcoat
  157. examine wedding ring
  158. examine lighthouse
  159. go southeast
  160. inventory
  161. examine ring
  162. examine
  163. search
  164. take
  165. inventory
  166. look
  167. look around
  168. take inventory
  169. look
  170. go north
  171. look
  172. go east
  173. look
  174. go west

✓ Solution saved to: anchor_solution.json

✓ Walkthrough generated: anchor_solution.json
  Rooms visited: 1
  Commands: 174

STEP 2: Compiling with z2js...
----------------------------------------------------------------------
  Compiling anchor with z2js...
  ✓ Generated z2js_output/anchor.js (854,885 bytes)

======================================================================
GAME 2/5: Photopia (#6 tie in 2023 Top 50)
File: games/zcode/photopia.z5
======================================================================

STEP 1: Generating walkthrough with AI...
----------------------------------------------------------------------
Loading games/zcode/photopia.z5...
============================================================
GAME START
============================================================




Photopia 1.30 is a stripped-down version designed for online play. The recommended version is 2.01, which runs in a Glulx player. Links are available at http://adamcadre.ac.

Would you like instructions? 

Using Anthropic Claude for AI assistance...

============================================================
ITERATION 1
============================================================
Room: Object (ID: 2)
Inventory: empty
Exits: none
Objects: none

AI analyzing...
Priority: medium
Suggested commands: ['look', 'examine', 'get', 'go', 'talk']

> look
Please answer yes or no.> 

> examine
Please answer yes or no.> 

> get
Please answer yes or no.> 

> go
Please answer yes or no.> 

> talk
Please answer yes or no.> 

No interesting AI suggestions. Trying basic directions...

============================================================
ITERATION 2
============================================================
Room: Object (ID: 2)
Inventory: empty
Exits: none
Objects: none

AI analyzing...
Priority: medium
Suggested commands: ['yes', 'no', 'inventory', 'look', 'examine']

> yes


"Okay, so I've finished reading the opening paragraphs. What am I supposed to do with this > thingy?"

Good question. The > prompt appears whenever it is your turn to tell the game what you want to do. Simply type in an imperative statement, like OPEN THE DOOR, or EAT THE SANDWICH, and press the E...
✓ Something interesting happened!

> no










                                                                                                        "Will you read me a story?"                                                                                                        "Read you a story? What fun would that be? I've        ...
✓ Moved to new room!

============================================================
ITERATION 3
============================================================
Room: east (ID: 9)
Inventory: empty
Exits: none
Objects: none

AI analyzing...
Priority: medium
Puzzles detected: ['Figuring out how to collaboratively tell a story with the other character']
Suggested commands: ['talk to', 'ask about', 'tell', 'look', 'examine', 'read']

> talk to




Speeding down Montgomery Boulevard
The streetlights are bright. Unbearably bright. You have to squint as hard as you can to keep your retinas from bursting into flame.

"Welcome back to the land of the LIVING, bud," Rob says. "You planning to stick around for a while or you gonna pass out again?...
✓ Moved to new room!

============================================================
ITERATION 4
============================================================
Room: Object (ID: 2)
Inventory: empty
Exits: no
Objects: none

AI analyzing...
Priority: high
Puzzles detected: ['How did the player end up in this situation?', 'What happened during the day that is being referenced?', 'Is there anything the player can do to influence the current car ride?']
Suggested commands: ['talk to rob', 'ask rob about the day', 'examine car', 'look out the window', 'search the car']

> talk to rob
Please select one:

(1) >ASK ROB ABOUT BLOOD ALCOHOL LEVEL
(2) >ASK ROB ABOUT THOSE CHICKS
(3) >YOU IDIOT, PULL OVER

Select an option or 0 to say nothing >> 
✓ Something interesting happened!

> ask rob about the day
Select an option or 0 to say nothing >> 

> examine car
Select an option or 0 to say nothing >> 

> look out the window
Select an option or 0 to say nothing >> 

> search the car
Select an option or 0 to say nothing >> 

============================================================
ITERATION 5
============================================================
Room: Object (ID: 2)
Inventory: empty
Exits: no
Objects: none

AI analyzing...
Priority: medium
Puzzles detected: ["Finding a way to control the car or influence Rob's actions"]
Suggested commands: ['examine car', 'search car', 'examine backseat', 'examine glove compartment', 'examine console']

> examine car
Select an option or 0 to say nothing >> 

> search car
Select an option or 0 to say nothing >> 

> examine backseat
Select an option or 0 to say nothing >> 

> examine glove compartment
Select an option or 0 to say nothing >> 

> examine console
Select an option or 0 to say nothing >> 

No interesting AI suggestions. Trying basic directions...

============================================================
ITERATION 6
============================================================
Room: Object (ID: 2)
Inventory: empty
Exits: no
Objects: none

AI analyzing...
Priority: medium
Suggested commands: ['look', 'examine', 'inventory', 'help']

> look
Select an option or 0 to say nothing >> 

> examine
Select an option or 0 to say nothing >> 

> inventory
Select an option or 0 to say nothing >> 

> help
Select an option or 0 to say nothing >> 

No interesting AI suggestions. Trying basic directions...

============================================================
ITERATION 7
============================================================
Room: Object (ID: 2)
Inventory: empty
Exits: no
Objects: none

AI analyzing...
Priority: low
Suggested commands: ['look', 'examine room', 'inventory', 'help']

> look
Select an option or 0 to say nothing >> 

> examine room
Select an option or 0 to say nothing >> 

> inventory
Select an option or 0 to say nothing >> 

> help
Select an option or 0 to say nothing >> 

No interesting AI suggestions. Trying basic directions...

============================================================
ITERATION 8
============================================================
Room: Object (ID: 2)
Inventory: empty
Exits: no
Objects: none

AI analyzing...
Priority: low
Suggested commands: ['look', 'examine', 'take']

> look
Select an option or 0 to say nothing >> 

> examine
Select an option or 0 to say nothing >> 

> take
Select an option or 0 to say nothing >> 

No interesting AI suggestions. Trying basic directions...

============================================================
ITERATION 9
============================================================
Room: Object (ID: 2)
Inventory: empty
Exits: no
Objects: none

AI analyzing...
Priority: high
Puzzles detected: ['Determining how to access the recommended version 2.01 of the game']
Suggested commands: ['examine', 'look', 'help', 'inventory', 'take', 'read']

> examine
Select an option or 0 to say nothing >> 

> look
Select an option or 0 to say nothing >> 

> help
Select an option or 0 to say nothing >> 

> inventory
Select an option or 0 to say nothing >> 

> take
Select an option or 0 to say nothing >> 

No interesting AI suggestions. Trying basic directions...

============================================================
ITERATION 10
============================================================
Room: Object (ID: 2)
Inventory: empty
Exits: no
Objects: none

AI analyzing...
Priority: high
Suggested commands: ['look', 'examine room', 'examine description', 'examine exits']

> look
Select an option or 0 to say nothing >> 

> examine room
Select an option or 0 to say nothing >> 

> examine description
Select an option or 0 to say nothing >> 

> examine exits
Select an option or 0 to say nothing >> 

No interesting AI suggestions. Trying basic directions...

============================================================
ITERATION 11
============================================================
Room: Object (ID: 2)
Inventory: empty
Exits: no
Objects: none

AI analyzing...
Priority: medium
Puzzles detected: ['The game may have puzzles or obstacles that require specific commands or interactions to progress, based on the limited options presented so far.']
Suggested commands: ['look', 'examine room', 'examine description', 'examine exits', 'examine vocabulary']

> look
Select an option or 0 to say nothing >> 

> examine room
Select an option or 0 to say nothing >> 

> examine description
Select an option or 0 to say nothing >> 

> examine exits
Select an option or 0 to say nothing >> 

> examine vocabulary
Select an option or 0 to say nothing >> 

No interesting AI suggestions. Trying basic directions...

============================================================
ITERATION 12
============================================================
Room: Object (ID: 2)
Inventory: empty
Exits: no
Objects: none

AI analyzing...
Priority: high
Suggested commands: ['look', 'examine', 'take']

> look
Select an option or 0 to say nothing >> 

> examine
Select an option or 0 to say nothing >> 

> take
Select an option or 0 to say nothing >> 

No interesting AI suggestions. Trying basic directions...

============================================================
ITERATION 13
============================================================
Room: Object (ID: 2)
Inventory: empty
Exits: no
Objects: none

AI analyzing...
Priority: high
Puzzles detected: ['Determining how to progress beyond the starting room']
Suggested commands: ['look', 'examine room', 'examine description', 'examine objects', 'inventory']

> look
Select an option or 0 to say nothing >> 

> examine room
Select an option or 0 to say nothing >> 

> examine description
Select an option or 0 to say nothing >> 

> examine objects
Select an option or 0 to say nothing >> 

> inventory
Select an option or 0 to say nothing >> 

No interesting AI suggestions. Trying basic directions...

============================================================
ITERATION 14
============================================================
Room: Object (ID: 2)
Inventory: empty
Exits: no
Objects: none

AI analyzing...
Priority: high
Puzzles detected: ['The game appears to be a stripped-down version of Photopia, so the player may need to find a way to access the recommended version 2.01 to progress further.']
Suggested commands: ['look', 'examine', 'take', 'read', 'help']

> look
Select an option or 0 to say nothing >> 

> examine
Select an option or 0 to say nothing >> 

> take
Select an option or 0 to say nothing >> 

> read
Select an option or 0 to say nothing >> 

> help
Select an option or 0 to say nothing >> 

No interesting AI suggestions. Trying basic directions...

============================================================
ITERATION 15
============================================================
Room: Object (ID: 2)
Inventory: empty
Exits: no
Objects: none

AI analyzing...
Priority: high
Suggested commands: ['examine', 'look around', 'take inventory', 'help', 'about']

> examine
Select an option or 0 to say nothing >> 

> look around
Select an option or 0 to say nothing >> 

> take inventory
Select an option or 0 to say nothing >> 

> help
Select an option or 0 to say nothing >> 

> about
Select an option or 0 to say nothing >> 

No interesting AI suggestions. Trying basic directions...

============================================================
ITERATION 16
============================================================
Room: Object (ID: 2)
Inventory: empty
Exits: no
Objects: none

AI analyzing...
Priority: medium
Puzzles detected: ['How to access the recommended version 2.01 of the game']
Suggested commands: ['look', 'examine room', 'examine description', 'help', 'inventory']

> look
Select an option or 0 to say nothing >> 

> examine room
Select an option or 0 to say nothing >> 

> examine description
Select an option or 0 to say nothing >> 

> help
Select an option or 0 to say nothing >> 

> inventory
Select an option or 0 to say nothing >> 

No interesting AI suggestions. Trying basic directions...

============================================================
ITERATION 17
============================================================
Room: Object (ID: 2)
Inventory: empty
Exits: no
Objects: none

AI analyzing...
Priority: medium
Puzzles detected: ['No apparent puzzles yet, but the game may require navigating through rooms or interacting with objects to progress.']
Suggested commands: ['look', 'examine', 'search', 'get', 'read']

> look
Select an option or 0 to say nothing >> 

> examine
Select an option or 0 to say nothing >> 

> search
Select an option or 0 to say nothing >> 

> get
Select an option or 0 to say nothing >> 

> read
Select an option or 0 to say nothing >> 

No interesting AI suggestions. Trying basic directions...

============================================================
ITERATION 18
============================================================
Room: Object (ID: 2)
Inventory: empty
Exits: no
Objects: none

AI analyzing...
Priority: medium
Suggested commands: ['examine', 'take', 'talk to', 'look']

> examine
Select an option or 0 to say nothing >> 

> take
Select an option or 0 to say nothing >> 

> talk to
Select an option or 0 to say nothing >> 

> look
Select an option or 0 to say nothing >> 

No interesting AI suggestions. Trying basic directions...

============================================================
ITERATION 19
============================================================
Room: Object (ID: 2)
Inventory: empty
Exits: no
Objects: none

AI analyzing...
Priority: high
Puzzles detected: ['Finding the recommended version of the game', 'Determining how to progress from this starting point']
Suggested commands: ['look', 'examine room', 'examine description', 'examine exits', 'examine vocabulary']

> look
Select an option or 0 to say nothing >> 

> examine room
Select an option or 0 to say nothing >> 

> examine description
Select an option or 0 to say nothing >> 

> examine exits
Select an option or 0 to say nothing >> 

> examine vocabulary
Select an option or 0 to say nothing >> 

No interesting AI suggestions. Trying basic directions...

============================================================
ITERATION 20
============================================================
Room: Object (ID: 2)
Inventory: empty
Exits: no
Objects: none

AI analyzing...
Priority: medium
Suggested commands: ['look', 'examine', 'take', 'inventory', 'help']

> look
Select an option or 0 to say nothing >> 

> examine
Select an option or 0 to say nothing >> 

> take
Select an option or 0 to say nothing >> 

> inventory
Select an option or 0 to say nothing >> 

> help
Select an option or 0 to say nothing >> 

No interesting AI suggestions. Trying basic directions...

============================================================
ITERATION 21
============================================================
Room: Object (ID: 2)
Inventory: empty
Exits: no
Objects: none

AI analyzing...
Priority: medium
Puzzles detected: ['Figuring out how to access the recommended 2.01 version of the game']
Suggested commands: ['look', 'examine room', 'examine description', 'read description', 'ask about', 'help']

> look
Select an option or 0 to say nothing >> 

> examine room
Select an option or 0 to say nothing >> 

> examine description
Select an option or 0 to say nothing >> 

> read description
Select an option or 0 to say nothing >> 

> ask about
Select an option or 0 to say nothing >> 

No interesting AI suggestions. Trying basic directions...

============================================================
ITERATION 22
============================================================
Room: Object (ID: 2)
Inventory: empty
Exits: no
Objects: none

AI analyzing...
Priority: medium
Suggested commands: ['look', 'examine', 'get', 'take', 'read']

> look
Select an option or 0 to say nothing >> 

> examine
Select an option or 0 to say nothing >> 

> get
Select an option or 0 to say nothing >> 

> take
Select an option or 0 to say nothing >> 

> read
Select an option or 0 to say nothing >> 

No interesting AI suggestions. Trying basic directions...

============================================================
ITERATION 23
============================================================
Room: Object (ID: 2)
Inventory: empty
Exits: no
Objects: none

AI analyzing...
Priority: high
Suggested commands: ['examine', 'look', 'help', 'inventory', 'about']

> examine
Select an option or 0 to say nothing >> 

> look
Select an option or 0 to say nothing >> 

> help
Select an option or 0 to say nothing >> 

> inventory
Select an option or 0 to say nothing >> 

> about
Select an option or 0 to say nothing >> 

No interesting AI suggestions. Trying basic directions...

============================================================
ITERATION 24
============================================================
Room: Object (ID: 2)
Inventory: empty
Exits: no
Objects: none

AI analyzing...
Priority: medium
Puzzles detected: ['The game seems to be a stripped-down version, so there may be a puzzle or challenge involved in finding the recommended 2.01 version and learning how to run it.']
Suggested commands: ['look', 'examine', 'inventory', 'examine description', 'help']

> look
Select an option or 0 to say nothing >> 

> examine
Select an option or 0 to say nothing >> 

> inventory
Select an option or 0 to say nothing >> 

> examine description
Select an option or 0 to say nothing >> 

> help
Select an option or 0 to say nothing >> 

No interesting AI suggestions. Trying basic directions...

============================================================
ITERATION 25
============================================================
Room: Object (ID: 2)
Inventory: empty
Exits: no
Objects: none

AI analyzing...
Priority: medium
Suggested commands: ['examine', 'look', 'help', 'inventory', 'take', 'drop']

> examine
Select an option or 0 to say nothing >> 

> look
Select an option or 0 to say nothing >> 

> help
Select an option or 0 to say nothing >> 

> inventory
Select an option or 0 to say nothing >> 

> take
Select an option or 0 to say nothing >> 

No interesting AI suggestions. Trying basic directions...

============================================================
ITERATION 26
============================================================
Room: Object (ID: 2)
Inventory: empty
Exits: no
Objects: none

AI analyzing...
Priority: medium
Suggested commands: ['look', 'examine', 'get', 'take']

> look
Select an option or 0 to say nothing >> 

> examine
Select an option or 0 to say nothing >> 

> get
Select an option or 0 to say nothing >> 

> take
Select an option or 0 to say nothing >> 

No interesting AI suggestions. Trying basic directions...

============================================================
ITERATION 27
============================================================
Room: Object (ID: 2)
Inventory: empty
Exits: no
Objects: none

AI analyzing...
Priority: high
Suggested commands: ['look', 'examine description', 'examine vocabulary', 'examine exits', 'help']

> look
Select an option or 0 to say nothing >> 

> examine description
Select an option or 0 to say nothing >> 

> examine vocabulary
Select an option or 0 to say nothing >> 

> examine exits
Select an option or 0 to say nothing >> 

> help
Select an option or 0 to say nothing >> 

No interesting AI suggestions. Trying basic directions...

============================================================
ITERATION 28
============================================================
Room: Object (ID: 2)
Inventory: empty
Exits: no
Objects: none

AI analyzing...
Priority: medium
Suggested commands: ['look', 'examine', 'take', 'north', 'inventory']

> look
Select an option or 0 to say nothing >> 

> examine
Select an option or 0 to say nothing >> 

> take
Select an option or 0 to say nothing >> 

> north
Select an option or 0 to say nothing >> 

> inventory
Select an option or 0 to say nothing >> 

No interesting AI suggestions. Trying basic directions...

============================================================
ITERATION 29
============================================================
Room: Object (ID: 2)
Inventory: empty
Exits: no
Objects: none

AI analyzing...
Priority: high
Suggested commands: ['examine room', 'examine description', 'examine exits', 'examine vocabulary']

> examine room
Select an option or 0 to say nothing >> 

> examine description
Select an option or 0 to say nothing >> 

> examine exits
Select an option or 0 to say nothing >> 

> examine vocabulary
Select an option or 0 to say nothing >> 

No interesting AI suggestions. Trying basic directions...

============================================================
ITERATION 30
============================================================
Room: Object (ID: 2)
Inventory: empty
Exits: no
Objects: none

AI analyzing...
Priority: high
Suggested commands: ['look', 'examine', 'inventory', 'help']

> look
Select an option or 0 to say nothing >> 

> examine
Select an option or 0 to say nothing >> 

> inventory
Select an option or 0 to say nothing >> 

> help
Select an option or 0 to say nothing >> 

No interesting AI suggestions. Trying basic directions...

============================================================
ITERATION 31
============================================================
Room: Object (ID: 2)
Inventory: empty
Exits: no
Objects: none

AI analyzing...
Priority: medium
Puzzles detected: ['The game state suggests that there may be a puzzle or task related to the different versions of Photopia, and the player may need to find a way to access the recommended version 2.01.']
Suggested commands: ['look', 'examine', 'talk', 'read', 'help']

> look
Select an option or 0 to say nothing >> 

> examine
Select an option or 0 to say nothing >> 

> talk
Select an option or 0 to say nothing >> 

> read
Select an option or 0 to say nothing >> 

> help
Select an option or 0 to say nothing >> 

No interesting AI suggestions. Trying basic directions...

============================================================
ITERATION 32
============================================================
Room: Object (ID: 2)
Inventory: empty
Exits: no
Objects: none

AI analyzing...
Priority: medium
Puzzles detected: ['Finding the recommended version of the game (2.01) and learning how to play it']
Suggested commands: ['examine', 'look', 'read', 'help']

> examine
Select an option or 0 to say nothing >> 

> look
Select an option or 0 to say nothing >> 

> read
Select an option or 0 to say nothing >> 

> help
Select an option or 0 to say nothing >> 

No interesting AI suggestions. Trying basic directions...

============================================================
ITERATION 33
============================================================
Room: Object (ID: 2)
Inventory: empty
Exits: no
Objects: none

AI analyzing...
Priority: medium
Suggested commands: ['look', 'examine', 'take', 'inventory', 'help']

> look
Select an option or 0 to say nothing >> 

> examine
Select an option or 0 to say nothing >> 

> take
Select an option or 0 to say nothing >> 

> inventory
Select an option or 0 to say nothing >> 

> help
Select an option or 0 to say nothing >> 

No interesting AI suggestions. Trying basic directions...

============================================================
ITERATION 34
============================================================
Room: Object (ID: 2)
Inventory: empty
Exits: no
Objects: none

AI analyzing...
Priority: high
Puzzles detected: ['Obtaining the recommended version 2.01 of Photopia']
Suggested commands: ['look', 'examine', 'read', 'take', 'inventory']

> look
Select an option or 0 to say nothing >> 

> examine
Select an option or 0 to say nothing >> 

> read
Select an option or 0 to say nothing >> 

> take
Select an option or 0 to say nothing >> 

> inventory
Select an option or 0 to say nothing >> 

No interesting AI suggestions. Trying basic directions...

============================================================
ITERATION 35
============================================================
Room: Object (ID: 2)
Inventory: empty
Exits: no
Objects: none

AI analyzing...
Priority: high
Puzzles detected: ['There are no obvious puzzles or obstacles mentioned in the current game state.']
Suggested commands: ['look', 'examine room', 'examine description', 'examine vocabulary']

> look
Select an option or 0 to say nothing >> 

> examine room
Select an option or 0 to say nothing >> 

> examine description
Select an option or 0 to say nothing >> 

> examine vocabulary
Select an option or 0 to say nothing >> 

No interesting AI suggestions. Trying basic directions...

============================================================
ITERATION 36
============================================================
Room: Object (ID: 2)
Inventory: empty
Exits: no
Objects: none

AI analyzing...
Priority: medium
Suggested commands: ['examine', 'look', 'inventory', 'help']

> examine
Select an option or 0 to say nothing >> 

> look
Select an option or 0 to say nothing >> 

> inventory
Select an option or 0 to say nothing >> 

> help
Select an option or 0 to say nothing >> 

No interesting AI suggestions. Trying basic directions...

============================================================
ITERATION 37
============================================================
Room: Object (ID: 2)
Inventory: empty
Exits: no
Objects: none

AI analyzing...
Priority: high
Puzzles detected: ['None apparent from the current information']
Suggested commands: ['examine room', 'look around', 'examine description', 'examine vocabulary', 'examine exits']

> examine room
Select an option or 0 to say nothing >> 

> look around
Select an option or 0 to say nothing >> 

> examine description
Select an option or 0 to say nothing >> 

> examine vocabulary
Select an option or 0 to say nothing >> 

> examine exits
Select an option or 0 to say nothing >> 

No interesting AI suggestions. Trying basic directions...

============================================================
ITERATION 38
============================================================
Room: Object (ID: 2)
Inventory: empty
Exits: no
Objects: none

AI analyzing...
Priority: low
Suggested commands: ['examine', 'look', 'inventory', 'help']

> examine
Select an option or 0 to say nothing >> 

> look
Select an option or 0 to say nothing >> 

> inventory
Select an option or 0 to say nothing >> 

> help
Select an option or 0 to say nothing >> 

No interesting AI suggestions. Trying basic directions...

============================================================
ITERATION 39
============================================================
Room: Object (ID: 2)
Inventory: empty
Exits: no
Objects: none

AI analyzing...
Priority: medium
Puzzles detected: ['Accessing the recommended version 2.01 of Photopia']
Suggested commands: ['look', 'examine', 'take', 'inventory', 'help']

> look
Select an option or 0 to say nothing >> 

> examine
Select an option or 0 to say nothing >> 

> take
Select an option or 0 to say nothing >> 

> inventory
Select an option or 0 to say nothing >> 

> help
Select an option or 0 to say nothing >> 

No interesting AI suggestions. Trying basic directions...

============================================================
ITERATION 40
============================================================
Room: Object (ID: 2)
Inventory: empty
Exits: no
Objects: none

AI analyzing...
Priority: medium
Puzzles detected: ['Finding the correct version of Photopia to play', 'Navigating to the next room']
Suggested commands: ['look', 'examine room', 'examine description', 'read', 'help']

> look
Select an option or 0 to say nothing >> 

> examine room
Select an option or 0 to say nothing >> 

> examine description
Select an option or 0 to say nothing >> 

> read
Select an option or 0 to say nothing >> 

> help
Select an option or 0 to say nothing >> 

No interesting AI suggestions. Trying basic directions...

============================================================
ITERATION 41
============================================================
Room: Object (ID: 2)
Inventory: empty
Exits: no
Objects: none

AI analyzing...
Priority: high
Suggested commands: ['look', 'examine room', 'examine description', 'examine vocabulary', 'help']

> look
Select an option or 0 to say nothing >> 

> examine room
Select an option or 0 to say nothing >> 

> examine description
Select an option or 0 to say nothing >> 

> examine vocabulary
Select an option or 0 to say nothing >> 

> help
Select an option or 0 to say nothing >> 

No interesting AI suggestions. Trying basic directions...

============================================================
ITERATION 42
============================================================
Room: Object (ID: 2)
Inventory: empty
Exits: no
Objects: none

AI analyzing...
Priority: medium
Puzzles detected: ['None apparent from the current information']
Suggested commands: ['look', 'examine', 'read', 'help', 'author']

> look
Select an option or 0 to say nothing >> 

> examine
Select an option or 0 to say nothing >> 

> read
Select an option or 0 to say nothing >> 

> help
Select an option or 0 to say nothing >> 

> author
Select an option or 0 to say nothing >> 

No interesting AI suggestions. Trying basic directions...

============================================================
ITERATION 43
============================================================
Room: Object (ID: 2)
Inventory: empty
Exits: no
Objects: none

AI analyzing...
Priority: medium
Puzzles detected: ['Finding the recommended version of the game to play']
Suggested commands: ['examine', 'look', 'read', 'help', 'inventory']

> examine
Select an option or 0 to say nothing >> 

> look
Select an option or 0 to say nothing >> 

> read
Select an option or 0 to say nothing >> 

> help
Select an option or 0 to say nothing >> 

> inventory
Select an option or 0 to say nothing >> 

No interesting AI suggestions. Trying basic directions...

============================================================
ITERATION 44
============================================================
Room: Object (ID: 2)
Inventory: empty
Exits: no
Objects: none

AI analyzing...
Priority: high
Suggested commands: ['look', 'examine description', 'examine exits', 'examine vocabulary']

> look
Select an option or 0 to say nothing >> 

> examine description
Select an option or 0 to say nothing >> 

> examine exits
Select an option or 0 to say nothing >> 

> examine vocabulary
Select an option or 0 to say nothing >> 

No interesting AI suggestions. Trying basic directions...

============================================================
ITERATION 45
============================================================
Room: Object (ID: 2)
Inventory: empty
Exits: no
Objects: none

AI analyzing...
Priority: high
Suggested commands: ['look', 'examine', 'inventory', 'help']

> look
Select an option or 0 to say nothing >> 

> examine
Select an option or 0 to say nothing >> 

> inventory
Select an option or 0 to say nothing >> 

> help
Select an option or 0 to say nothing >> 

No interesting AI suggestions. Trying basic directions...

============================================================
ITERATION 46
============================================================
Room: Object (ID: 2)
Inventory: empty
Exits: no
Objects: none

AI analyzing...
Priority: medium
Suggested commands: ['look', 'examine', 'take inventory', 'examine description', 'examine exits']

> look
Select an option or 0 to say nothing >> 

> examine
Select an option or 0 to say nothing >> 

> take inventory
Select an option or 0 to say nothing >> 

> examine description
Select an option or 0 to say nothing >> 

> examine exits
Select an option or 0 to say nothing >> 

No interesting AI suggestions. Trying basic directions...

============================================================
ITERATION 47
============================================================
Room: Object (ID: 2)
Inventory: empty
Exits: no
Objects: none

AI analyzing...
Priority: medium
Suggested commands: ['examine room', 'examine description', 'examine vocabulary', 'look', 'help']

> examine room
Select an option or 0 to say nothing >> 

> examine description
Select an option or 0 to say nothing >> 

> examine vocabulary
Select an option or 0 to say nothing >> 

> look
Select an option or 0 to say nothing >> 

> help
Select an option or 0 to say nothing >> 

No interesting AI suggestions. Trying basic directions...

============================================================
ITERATION 48
============================================================
Room: Object (ID: 2)
Inventory: empty
Exits: no
Objects: none

AI analyzing...
Priority: medium
Puzzles detected: ['Finding the recommended version of the game', 'Navigating to a different location']
Suggested commands: ['examine room', 'examine description', 'look', 'help', 'instructions']

> examine room
Select an option or 0 to say nothing >> 

> examine description
Select an option or 0 to say nothing >> 

> look
Select an option or 0 to say nothing >> 

> help
Select an option or 0 to say nothing >> 

> instructions
Select an option or 0 to say nothing >> 

No interesting AI suggestions. Trying basic directions...

============================================================
ITERATION 49
============================================================
Room: Object (ID: 2)
Inventory: empty
Exits: no
Objects: none

AI analyzing...
Priority: high
Puzzles detected: ['None apparent at this stage']
Suggested commands: ['look', 'examine room', 'examine description', 'examine vocabulary', 'help']

> look
Select an option or 0 to say nothing >> 

> examine room
Select an option or 0 to say nothing >> 

> examine description
Select an option or 0 to say nothing >> 

> examine vocabulary
Select an option or 0 to say nothing >> 

> help
Select an option or 0 to say nothing >> 

No interesting AI suggestions. Trying basic directions...

============================================================
ITERATION 50
============================================================
Room: Object (ID: 2)
Inventory: empty
Exits: no
Objects: none

AI analyzing...
Priority: high
Puzzles detected: ['Finding the recommended version of Photopia (2.01) and how to access it.']
Suggested commands: ['look', 'examine', 'take', 'inventory', 'read']

> look
Select an option or 0 to say nothing >> 

> examine
Select an option or 0 to say nothing >> 

> take
Select an option or 0 to say nothing >> 

> inventory
Select an option or 0 to say nothing >> 

> read
Select an option or 0 to say nothing >> 

No interesting AI suggestions. Trying basic directions...

============================================================
SOLUTION SUMMARY
============================================================
Rooms discovered: 2
Commands in solution: 4

Solution path:
  1. yes
  2. no
  3. talk to
  4. talk to rob

✓ Solution saved to: photopia_solution.json

✓ Walkthrough generated: photopia_solution.json
  Rooms visited: 2
  Commands: 4

STEP 2: Compiling with z2js...
----------------------------------------------------------------------
  Compiling photopia with z2js...
  ✓ Generated z2js_output/photopia.js (441,397 bytes)

======================================================================
GAME 3/5: Lost Pig (#8 tie in 2023 Top 50)
File: games/zcode/lostpig.z8
======================================================================

STEP 1: Generating walkthrough with AI...
----------------------------------------------------------------------
Loading games/zcode/lostpig.z8...
============================================================
GAME START
============================================================




Pig lost! Boss say that it Grunk fault. Say Grunk forget about closing gate. Maybe boss right. Grunk not remember forgetting, but maybe Grunk just forget. Boss say Grunk go find pig, bring it back. Him say, if Grunk not bring back pig, not bring back Grunk either. Grunk like working at pig farm, so now Grunk need find pig.

Lost Pig
And Place Under Ground
Release 2 / Serial number 080406 / Inform v6.30 6/11 / ZCODE-1-070917-994E
(For help, use "HELP".)

Outside
Grunk think that pig probably go this way. It hard to tell at night time, because moon not bright as sun. There forest to east and north. It even darker there, and Grunk hear lots of strange animal. West of Grunk, there big field with little stone wall. Farm back to south.

>Outside

Using Anthropic Claude for AI assistance...

============================================================
ITERATION 1
============================================================
Room: Outside (ID: 93)
Inventory: empty
Exits: none
Objects: moon, wall, field, forest, noise, tracks, farm

AI analyzing...
Priority: medium
Puzzles detected: ['Finding the missing pig', 'Navigating the dark forest']
Suggested commands: ['EXAMINE WALL', 'EXAMINE FIELD', 'EXAMINE FOREST', 'GO EAST', 'GO NORTH']

> EXAMINE WALL
Wall made of many big rock. It not very tall; Grunk lots taller than wall. Maybe it too hard, find enough big rock to make big wall. There field on other side of wall.

>Outside

> EXAMINE FIELD
Grunk confused. Not understand that at all.

>Outside
✓ Something interesting happened!

> EXAMINE FOREST
Many tree and bush and leaf and branch and other plant like that. That what forest mean. It dark, too. Pig probably some place in there, but Grunk not know which way to go.

>Outside
✓ Something interesting happened!

> GO EAST
Forest look dark. Pig probably some place in there, but Grunk not know which way to go. Not want end up lost in forest with no pig.

>Outside
✓ Something interesting happened!

> GO NORTH
Forest look dark. Pig probably some place in there, but Grunk not know which way to go. Not want end up lost in forest with no pig.

>Outside
✓ Something interesting happened!

============================================================
ITERATION 2
============================================================
Room: Outside (ID: 93)
Inventory: empty
Exits: none
Objects: moon, wall, field, forest, noise, tracks, farm

AI analyzing...
Priority: medium
Puzzles detected: ['Finding the missing pig', 'Navigating the dark forest safely']
Suggested commands: ['EXAMINE MOON', 'EXAMINE TRACKS', 'EXAMINE NOISE', 'GO WEST', 'GO SOUTH']

> EXAMINE MOON
Moon little and shiny, like coin. But it really high up.

>Outside
✓ Something interesting happened!

> EXAMINE TRACKS
Grunk not find any thing in dirt.

>Outside

> EXAMINE NOISE
Grunk not see any thing yet.

>Outside

> GO WEST
Grunk not allowed in field. That probably OK, because Grunk not think pig tall enough to climb over wall.

>Outside

> GO SOUTH
Grunk confused. Not understand that at all.

>Outside
✓ Something interesting happened!

============================================================
ITERATION 3
============================================================
Room: Outside (ID: 93)
Inventory: empty
Exits: none
Objects: moon, wall, field, forest, noise, tracks, farm

AI analyzing...
Priority: medium
Puzzles detected: ['Navigating the dark forest safely', 'Determining what the strange noises are', 'Finding a way to get over the wall']
Suggested commands: ['EXAMINE FOREST', 'GO EAST', 'EXAMINE WALL', 'GO NORTH', 'LISTEN']

> EXAMINE FOREST
Many tree and bush and leaf and branch and other plant like that. That what forest mean. It dark, too. Pig probably some place in there, but Grunk not know which way to go.

>Outside
✓ Something interesting happened!

> GO EAST
Forest look dark. Pig probably some place in there, but Grunk not know which way to go. Not want end up lost in forest with no pig.

Grunk hear noise! It come from some place in bushes, but Grunk not sure which way it come from.

>Outside
✓ Something interesting happened!

> EXAMINE WALL
Wall made of many big rock. It not very tall; Grunk lots taller than wall. Maybe it too hard, find enough big rock to make big wall. There field on other side of wall.

>Outside

> GO NORTH
Grunk confused. Not understand that at all.

>Outside
✓ Something interesting happened!

> LISTEN
Grunk get quiet. Listen for noise in dark.

There, hear noise again! It come from northeast. Must be pig, hiding in bushes.

[Grunk score go up one.]

>Outside
✓ Something interesting happened!

============================================================
ITERATION 4
============================================================
Room: Outside (ID: 93)
Inventory: empty
Exits: none
Objects: moon, wall, field, forest, noise, tracks, farm

AI analyzing...
Priority: high
Puzzles detected: ['Finding and catching the lost pig']
Suggested commands: ['GO NORTHEAST', 'EXAMINE NOISE', 'SEARCH BUSHES', 'FOLLOW TRACKS', 'CALL PIG']

> GO NORTHEAST
If that where pig go, that where Grunk go. It hard to see where Grunk going to, because there so much dark and leaves and branches here. Then suddenly, there not ground here any more!

Oof! Ow! Umf! Ugh!

Grunk fall down deep hole! Drop torch. Torch go out when Grunk land on it, so now it dark, too....
✓ Moved to new room!

============================================================
ITERATION 5
============================================================
Room: Hole (ID: 102)
Inventory: empty
Exits: none
Objects: dark, torch, broken stair, tunnel, curly bit, hole, crack

AI analyzing...
Priority: high
Puzzles detected: ['How to climb the broken stairs to get out of the hole', 'Determining the source of the noise and finding the pig']
Suggested commands: ['EXAMINE TORCH', 'TAKE TORCH', 'EXAMINE CRACK', 'EXAMINE STAIRS', 'CLIMB STAIRS']

> EXAMINE TORCH
Grunk bring torch because Grunk not good at seeing in dark.

One end of torch look black and sooty.

>Hole
✓ Something interesting happened!

> TAKE TORCH
OK, got it.

>Hole

> EXAMINE CRACK
Crack wide as Grunk fist, at least at top. It dark, so Grunk not see if anything there inside or how deep crack go.

>Hole
✓ Something interesting happened!

> EXAMINE STAIRS
That where Grunk fall down into hole. Stair go up pretty high. Made of rock, but rock all falling apart, so stair not much good for climbing anymore.

Look like some person leave little metal thing on step.

>Hole
✓ Something interesting happened!

> CLIMB STAIRS
Grunk try climbing up broken stairs, but that too hard when Grunk carry stuff too. 

>Hole
✓ Something interesting happened!

============================================================
ITERATION 6
============================================================
Room: Hole (ID: 102)
Inventory: empty
Exits: none
Objects: dark, torch, broken stair, tunnel, curly bit, hole, crack

AI analyzing...
Priority: medium
Puzzles detected: ['How to climb the broken stairs', 'What is the purpose of the metal thing on the stairs']
Suggested commands: ['EXAMINE CRACK', 'EXAMINE METAL THING', 'TAKE METAL THING', 'CLIMB STAIRS', 'EXAMINE TUNNEL']

> EXAMINE CRACK
Crack wide as Grunk fist, at least at top. It dark, so Grunk not see if anything there inside or how deep crack go.

>Hole
✓ Something interesting happened!

> EXAMINE METAL THING
Look like little metal tube, size of Grunk thumb.

>Hole
✓ Something interesting happened!

> TAKE METAL THING
Grunk not see that there.

>Hole

> CLIMB STAIRS
Grunk try climbing up broken stairs, but that too hard when Grunk carry stuff too. 

>Hole
✓ Something interesting happened!

> EXAMINE TUNNEL
Hmm, look like there curly bit carved all around edge where tunnel start. Maybe some person think this place special.

>Hole
✓ Something interesting happened!

============================================================
ITERATION 7
============================================================
Room: Hole (ID: 102)
Inventory: empty
Exits: none
Objects: dark, torch, broken stair, tunnel, curly bit, hole, crack

AI analyzing...
Priority: medium
Puzzles detected: ['Getting out of the hole', 'Examining the crack for potential items or secrets']
Suggested commands: ['EXAMINE TUNNEL', 'EXAMINE CRACK', 'EXAMINE TORCH', 'TAKE TORCH', 'SEARCH HOLE']

> EXAMINE TUNNEL
Hmm, look like there curly bit carved all around edge where tunnel start. Maybe some person think this place special.

>Hole
✓ Something interesting happened!

> EXAMINE CRACK
Crack wide as Grunk fist, at least at top. It dark, so Grunk not see if anything there inside or how deep crack go.

>Hole
✓ Something interesting happened!

> EXAMINE TORCH
Grunk bring torch because Grunk not good at seeing in dark.

One end of torch look black and sooty.

>Hole
✓ Something interesting happened!

> TAKE TORCH
Grunk already have that!

>Hole

> SEARCH HOLE
Top of hole way up at top of stair. That pretty high up.

>Hole
✓ Something interesting happened!

============================================================
ITERATION 8
============================================================
Room: Hole (ID: 102)
Inventory: empty
Exits: none
Objects: dark, torch, broken stair, tunnel, curly bit, hole, crack

AI analyzing...
Priority: medium
Puzzles detected: ['The broken stairs may need to be repaired in order to exit the hole', 'The crack in the ground may hide something important']
Suggested commands: ['EXAMINE CRACK', 'EXAMINE STAIRS', 'GO EAST', 'CLIMB STAIRS']

> EXAMINE CRACK
Crack wide as Grunk fist, at least at top. It dark, so Grunk not see if anything there inside or how deep crack go.

>Hole
✓ Something interesting happened!

> EXAMINE STAIRS
That where Grunk fall down into hole. Stair go up pretty high. Made of rock, but rock all falling apart, so stair not much good for climbing anymore.

>Hole
✓ Something interesting happened!

> GO EAST

Fountain Room
All wall in this room glow! It bright, just like day time. Except that instead of sun, it wall that glow. And instead of grass and tree, it square room with four wall. And instead of outside, it all under ground. But beside those thing, it just like it! Tunnel keep going out to east a...

> CLIMB STAIRS
Grunk confused. Not understand that at all.

>Hole

============================================================
ITERATION 9
============================================================
Room: Hole (ID: 102)
Inventory: empty
Exits: none
Objects: dark, torch, broken stair, tunnel, curly bit, hole, crack

AI analyzing...
Priority: medium
Puzzles detected: ['Climbing out of the hole', 'Navigating the crack in the ground']
Suggested commands: ['EXAMINE TORCH', 'TAKE TORCH', 'GO WEST', 'EXAMINE CRACK', 'CLIMB CRACK']

> EXAMINE TORCH
Grunk bring torch because Grunk not good at seeing in dark.

One end of torch look black and sooty.

>Hole
✓ Something interesting happened!

> TAKE TORCH
Grunk already have that!

>Hole

> GO WEST
Grunk try climbing up broken stairs, but that too hard when Grunk carry stuff too. 

>Hole
✓ Something interesting happened!

> EXAMINE CRACK
Crack wide as Grunk fist, at least at top. It dark, so Grunk not see if anything there inside or how deep crack go.

>Hole
✓ Something interesting happened!

> CLIMB CRACK
Grunk not that good at climbing.

>Hole

============================================================
ITERATION 10
============================================================
Room: Hole (ID: 102)
Inventory: empty
Exits: none
Objects: dark, torch, broken stair, tunnel, curly bit, hole, crack

AI analyzing...
Priority: medium
Puzzles detected: ['Figuring out how to climb out of the hole, potentially through the crack or the tunnel', 'Determining the purpose or use of the torch']
Suggested commands: ['EXAMINE CRACK', 'GO EAST', 'EXAMINE TUNNEL', 'EXAMINE BROKEN STAIR', 'SEARCH']

> EXAMINE CRACK
Crack wide as Grunk fist, at least at top. It dark, so Grunk not see if anything there inside or how deep crack go.

>Hole
✓ Something interesting happened!

> GO EAST

Fountain Room
All wall in this room glow! It bright, just like day time. Except that instead of sun, it wall that glow. And instead of grass and tree, it square room with four wall. And instead of outside, it all under ground. But beside those thing, it just like it! Tunnel keep going out to east a...

> EXAMINE TUNNEL
Grunk confused. Not understand that at all.

>Hole

> EXAMINE BROKEN STAIR
That where Grunk fall down into hole. Stair go up pretty high. Made of rock, but rock all falling apart, so stair not much good for climbing anymore.

>Hole
✓ Something interesting happened!

> SEARCH
What Grunk search?

>Hole

============================================================
ITERATION 11
============================================================
Room: Hole (ID: 102)
Inventory: empty
Exits: none
Objects: dark, torch, broken stair, tunnel, curly bit, hole, crack

AI analyzing...
Priority: medium
Puzzles detected: ['The crack in the ground near the stairs may lead to something interesting or hidden.', 'The glowing walls and lack of water in the fountain suggest there may be a puzzle or unusual mechanic to discover.']
Suggested commands: ['EXAMINE TUNNEL', 'EXAMINE FOUNTAIN', 'EXAMINE CURTAIN', 'SEARCH CRACK', 'GO NORTH', 'GO SOUTHEAST', 'GO SOUTHWEST']

> EXAMINE TUNNEL
Hmm, look like there curly bit carved all around edge where tunnel start. Maybe some person think this place special.

>Hole
✓ Something interesting happened!

> EXAMINE FOUNTAIN
Grunk not see that there.

>Hole

> EXAMINE CURTAIN
Grunk not see that there.

>Hole

> SEARCH CRACK
It dark, so Grunk not see if anything there inside or how deep crack go.

>Hole
✓ Something interesting happened!

> GO NORTH
Tunnel and stairs only place that Grunk can go here. Tunnel go east; stairs go up.

>Hole
✓ Something interesting happened!

============================================================
ITERATION 12
============================================================
Room: Hole (ID: 102)
Inventory: empty
Exits: none
Objects: dark, torch, broken stair, tunnel, curly bit, hole, crack

AI analyzing...
Priority: medium
Puzzles detected: ['The stairs appear to be broken, so there may be a way to repair or navigate around them to reach the surface.', 'The crack in the ground could be hiding something important or lead to a new area.']
Suggested commands: ['EXAMINE TORCH', 'TAKE TORCH', 'GO EAST', 'GO UP STAIRS', 'SEARCH CRACK']

> EXAMINE TORCH
Grunk bring torch because Grunk not good at seeing in dark.

One end of torch look black and sooty.

>Hole
✓ Something interesting happened!

> TAKE TORCH
Grunk already have that!

>Hole

> GO EAST

Fountain Room
All wall in this room glow! It bright, just like day time. Except that instead of sun, it wall that glow. And instead of grass and tree, it square room with four wall. And instead of outside, it all under ground. But beside those thing, it just like it! Tunnel keep going out to east a...

> GO UP STAIRS
Grunk confused. Not understand that at all.

>Hole

> SEARCH CRACK
It dark, so Grunk not see if anything there inside or how deep crack go.

>Hole
✓ Something interesting happened!

============================================================
ITERATION 13
============================================================
Room: Hole (ID: 102)
Inventory: empty
Exits: none
Objects: dark, torch, broken stair, tunnel, curly bit, hole, crack

AI analyzing...
Priority: medium
Puzzles detected: ['Determine how to get up the broken stairs', 'Investigate the crack in the ground', 'Interact with the pig or the curtain in the Fountain Room']
Suggested commands: ['EXAMINE CRACK', 'EXAMINE STAIRS', 'SEARCH STAIRS', 'EXAMINE PIG', 'EXAMINE CURTAIN']

> EXAMINE CRACK
Crack wide as Grunk fist, at least at top. It dark, so Grunk not see if anything there inside or how deep crack go.

>Hole
✓ Something interesting happened!

> EXAMINE STAIRS
That where Grunk fall down into hole. Stair go up pretty high. Made of rock, but rock all falling apart, so stair not much good for climbing anymore.

>Hole
✓ Something interesting happened!

> SEARCH STAIRS
On top of broken stair there tube.

>Hole

> EXAMINE PIG
Grunk not see that there.

>Hole

> EXAMINE CURTAIN
Grunk not see that there.

>Hole

============================================================
ITERATION 14
============================================================
Room: Hole (ID: 102)
Inventory: empty
Exits: none
Objects: dark, torch, broken stair, tunnel, curly bit, hole, crack

AI analyzing...
Priority: high
Puzzles detected: ['Getting out of the hole by climbing the broken stairs or finding another way up', 'Exploring the tunnel to the east and discovering what lies beyond']
Suggested commands: ['EXAMINE CRACK', 'EXAMINE TUNNEL', 'TAKE TORCH', 'GO EAST', 'CLIMB STAIRS']

> EXAMINE CRACK
Crack wide as Grunk fist, at least at top. It dark, so Grunk not see if anything there inside or how deep crack go.

>Hole
✓ Something interesting happened!

> EXAMINE TUNNEL
Hmm, look like there curly bit carved all around edge where tunnel start. Maybe some person think this place special.

>Hole
✓ Something interesting happened!

> TAKE TORCH
Grunk already have that!

>Hole

> GO EAST

Fountain Room
All wall in this room glow! It bright, just like day time. Except that instead of sun, it wall that glow. And instead of grass and tree, it square room with four wall. And instead of outside, it all under ground. But beside those thing, it just like it! Tunnel keep going out to east a...

> CLIMB STAIRS
Grunk confused. Not understand that at all.

>Hole

============================================================
ITERATION 15
============================================================
Room: Hole (ID: 102)
Inventory: empty
Exits: none
Objects: dark, torch, broken stair, tunnel, curly bit, hole, crack

AI analyzing...
Priority: medium
Puzzles detected: ['Repairing the broken stairs to climb out of the hole', 'Navigating the crack in the ground', 'Interacting with the pig in some way']
Suggested commands: ['EXAMINE STAIRS', 'EXAMINE CRACK', 'EXAMINE PIG', 'TAKE TORCH', 'GO EAST']

> EXAMINE STAIRS
That where Grunk fall down into hole. Stair go up pretty high. Made of rock, but rock all falling apart, so stair not much good for climbing anymore.

>Hole
✓ Something interesting happened!

> EXAMINE CRACK
Crack wide as Grunk fist, at least at top. It dark, so Grunk not see if anything there inside or how deep crack go.

>Hole
✓ Something interesting happened!

> EXAMINE PIG
Grunk not see that there.

>Hole

> TAKE TORCH
Grunk already have that!

>Hole

> GO EAST

Fountain Room
All wall in this room glow! It bright, just like day time. Except that instead of sun, it wall that glow. And instead of grass and tree, it square room with four wall. And instead of outside, it all under ground. But beside those thing, it just like it! Tunnel keep going out to east a...

============================================================
ITERATION 16
============================================================
Room: Hole (ID: 102)
Inventory: empty
Exits: none
Objects: dark, torch, broken stair, tunnel, curly bit, hole, crack

AI analyzing...
Priority: medium
Puzzles detected: ['Activating or repairing the fountain may be a puzzle to solve.', 'The curtain may hide something important behind it.']
Suggested commands: ['EXAMINE FOUNTAIN', 'EXAMINE CURTAIN', 'GO NORTH', 'GO SOUTHEAST', 'GO SOUTHWEST']

> EXAMINE FOUNTAIN
Grunk confused. Not understand that at all.

>Hole

> EXAMINE CURTAIN
Grunk not see that there.

>Hole

> GO NORTH
Tunnel and stairs only place that Grunk can go here. Tunnel go east; stairs go up.

>Hole
✓ Something interesting happened!

> GO SOUTHEAST
Tunnel and stairs only place that Grunk can go here. Tunnel go east; stairs go up.

>Hole
✓ Something interesting happened!

> GO SOUTHWEST
Tunnel and stairs only place that Grunk can go here. Tunnel go east; stairs go up.

>Hole
✓ Something interesting happened!

============================================================
ITERATION 17
============================================================
Room: Hole (ID: 102)
Inventory: empty
Exits: none
Objects: dark, torch, broken stair, tunnel, curly bit, hole, crack

AI analyzing...
Priority: medium
Puzzles detected: ['The stairs are broken, so there may be a way to fix or navigate them.', 'The crack in the ground could be an obstacle or hiding something important.']
Suggested commands: ['EXAMINE TORCH', 'TAKE TORCH', 'GO EAST', 'GO WEST', 'EXAMINE CRACK']

> EXAMINE TORCH
Grunk bring torch because Grunk not good at seeing in dark.

One end of torch look black and sooty.

>Hole
✓ Something interesting happened!

> TAKE TORCH
Grunk already have that!

>Hole

> GO EAST

Fountain Room
All wall in this room glow! It bright, just like day time. Except that instead of sun, it wall that glow. And instead of grass and tree, it square room with four wall. And instead of outside, it all under ground. But beside those thing, it just like it! Tunnel keep going out to east a...

> GO WEST
Grunk confused. Not understand that at all.

>Hole

> EXAMINE CRACK
Crack wide as Grunk fist, at least at top. It dark, so Grunk not see if anything there inside or how deep crack go.

>Hole
✓ Something interesting happened!

============================================================
ITERATION 18
============================================================
Room: Hole (ID: 102)
Inventory: empty
Exits: none
Objects: dark, torch, broken stair, tunnel, curly bit, hole, crack

AI analyzing...
Priority: high
Puzzles detected: ['The crack in the ground could be a hazard or lead to a hidden area', 'The broken stairs may need to be repaired to allow access to the outside', 'The glowing walls and empty fountain suggest some kind of puzzle or mechanism to be solved']
Suggested commands: ['EXAMINE CRACK', 'GO WEST', 'EXAMINE PIG', 'EXAMINE CURTAIN', 'EXAMINE FOUNTAIN']

> EXAMINE CRACK
Crack wide as Grunk fist, at least at top. It dark, so Grunk not see if anything there inside or how deep crack go.

>Hole
✓ Something interesting happened!

> GO WEST
Grunk try climbing up broken stairs, but that too hard when Grunk carry stuff too. 

>Hole
✓ Something interesting happened!

> EXAMINE PIG
Grunk not see that there.

>Hole

> EXAMINE CURTAIN
Grunk not see that there.

>Hole

> EXAMINE FOUNTAIN
Grunk not see that there.

>Hole

============================================================
ITERATION 19
============================================================
Room: Hole (ID: 102)
Inventory: empty
Exits: none
Objects: dark, torch, broken stair, tunnel, curly bit, hole, crack

AI analyzing...
Priority: medium
Puzzles detected: ['Climbing the broken stairs to exit the hole', 'Determining what is inside the crack or where the tunnel leads']
Suggested commands: ['EXAMINE TORCH', 'TAKE TORCH', 'EXAMINE CRACK', 'GO EAST', 'EXAMINE TUNNEL']

> EXAMINE TORCH
Grunk bring torch because Grunk not good at seeing in dark.

One end of torch look black and sooty.

>Hole
✓ Something interesting happened!

> TAKE TORCH
Grunk already have that!

>Hole

> EXAMINE CRACK
Crack wide as Grunk fist, at least at top. It dark, so Grunk not see if anything there inside or how deep crack go.

>Hole
✓ Something interesting happened!

> GO EAST

Fountain Room
All wall in this room glow! It bright, just like day time. Except that instead of sun, it wall that glow. And instead of grass and tree, it square room with four wall. And instead of outside, it all under ground. But beside those thing, it just like it! Tunnel keep going out to east a...

> EXAMINE TUNNEL
Grunk confused. Not understand that at all.

>Hole

============================================================
ITERATION 20
============================================================
Room: Hole (ID: 102)
Inventory: empty
Exits: none
Objects: dark, torch, broken stair, tunnel, curly bit, hole, crack

AI analyzing...
Priority: medium
Puzzles detected: ['The crack in the ground could be a potential hazard or lead to a hidden area', 'The broken stairs may need to be repaired or an alternate way to exit the hole could be found', 'The curtain on the south wall may hide something important']
Suggested commands: ['EXAMINE CRACK', 'GO WEST', 'EXAMINE STAIRS', 'EXAMINE PIG', 'EXAMINE CURTAIN']

> EXAMINE CRACK
Crack wide as Grunk fist, at least at top. It dark, so Grunk not see if anything there inside or how deep crack go.

>Hole
✓ Something interesting happened!

> GO WEST
Grunk try climbing up broken stairs, but that too hard when Grunk carry stuff too. 

>Hole
✓ Something interesting happened!

> EXAMINE STAIRS
That where Grunk fall down into hole. Stair go up pretty high. Made of rock, but rock all falling apart, so stair not much good for climbing anymore.

>Hole
✓ Something interesting happened!

> EXAMINE PIG
Grunk not see that there.

>Hole

> EXAMINE CURTAIN
Grunk not see that there.

>Hole

============================================================
ITERATION 21
============================================================
Room: Hole (ID: 102)
Inventory: empty
Exits: none
Objects: dark, torch, broken stair, tunnel, curly bit, hole, crack

AI analyzing...
Priority: medium
Puzzles detected: ['How to climb out of the hole', 'What is the purpose of the crack in the ground']
Suggested commands: ['EXAMINE TORCH', 'TAKE TORCH', 'GO EAST', 'EXAMINE CRACK', 'EXAMINE TUNNEL']

> EXAMINE TORCH
Grunk bring torch because Grunk not good at seeing in dark.

One end of torch look black and sooty.

>Hole
✓ Something interesting happened!

> TAKE TORCH
Grunk already have that!

>Hole

> GO EAST

Fountain Room
All wall in this room glow! It bright, just like day time. Except that instead of sun, it wall that glow. And instead of grass and tree, it square room with four wall. And instead of outside, it all under ground. But beside those thing, it just like it! Tunnel keep going out to east a...

> EXAMINE CRACK
Grunk confused. Not understand that at all.

>Hole

> EXAMINE TUNNEL
Hmm, look like there curly bit carved all around edge where tunnel start. Maybe some person think this place special.

>Hole
✓ Something interesting happened!

============================================================
ITERATION 22
============================================================
Room: Hole (ID: 102)
Inventory: empty
Exits: none
Objects: dark, torch, broken stair, tunnel, curly bit, hole, crack

AI analyzing...
Priority: medium
Puzzles detected: ['The broken stairs may need to be repaired or an alternate path found to reach the surface.', 'The crack in the ground may be a clue or an obstacle that needs to be addressed.', 'The curtain may hide a secret or lead to another area.']
Suggested commands: ['EXAMINE STAIRS', 'EXAMINE CRACK', 'EXAMINE CURTAIN', 'GO NORTH', 'GO SOUTHEAST', 'GO SOUTHWEST']

> EXAMINE STAIRS
That where Grunk fall down into hole. Stair go up pretty high. Made of rock, but rock all falling apart, so stair not much good for climbing anymore.

>Hole
✓ Something interesting happened!

> EXAMINE CRACK
Crack wide as Grunk fist, at least at top. It dark, so Grunk not see if anything there inside or how deep crack go.

>Hole
✓ Something interesting happened!

> EXAMINE CURTAIN
Grunk not see that there.

>Hole

> GO NORTH
Tunnel and stairs only place that Grunk can go here. Tunnel go east; stairs go up.

>Hole
✓ Something interesting happened!

> GO SOUTHEAST
Tunnel and stairs only place that Grunk can go here. Tunnel go east; stairs go up.

>Hole
✓ Something interesting happened!

============================================================
ITERATION 23
============================================================
Room: Hole (ID: 102)
Inventory: empty
Exits: none
Objects: dark, torch, broken stair, tunnel, curly bit, hole, crack

AI analyzing...
Priority: medium
Puzzles detected: ['The broken stairs may be a puzzle that needs to be solved to escape the hole.']
Suggested commands: ['EXAMINE TORCH', 'TAKE TORCH', 'GO EAST', 'GO WEST', 'EXAMINE CRACK']

> EXAMINE TORCH
Grunk bring torch because Grunk not good at seeing in dark.

One end of torch look black and sooty.

>Hole
✓ Something interesting happened!

> TAKE TORCH
Grunk already have that!

>Hole

> GO EAST

Fountain Room
All wall in this room glow! It bright, just like day time. Except that instead of sun, it wall that glow. And instead of grass and tree, it square room with four wall. And instead of outside, it all under ground. But beside those thing, it just like it! Tunnel keep going out to east a...

> GO WEST
Grunk confused. Not understand that at all.

>Hole

> EXAMINE CRACK
Crack wide as Grunk fist, at least at top. It dark, so Grunk not see if anything there inside or how deep crack go.

>Hole
✓ Something interesting happened!

============================================================
ITERATION 24
============================================================
Room: Hole (ID: 102)
Inventory: empty
Exits: none
Objects: dark, torch, broken stair, tunnel, curly bit, hole, crack

AI analyzing...
Priority: medium
Puzzles detected: ['The crack in the ground may lead to a hidden path or item', 'The pig may be involved in a puzzle or provide some useful information']
Suggested commands: ['EXAMINE CRACK', 'EXAMINE PIG', 'TAKE TORCH', 'GO WEST', 'GO NORTH']

> EXAMINE CRACK
Crack wide as Grunk fist, at least at top. It dark, so Grunk not see if anything there inside or how deep crack go.

>Hole
✓ Something interesting happened!

> EXAMINE PIG
Grunk not see that there.

>Hole

> TAKE TORCH
Grunk already have that!

>Hole

> GO WEST
Grunk try climbing up broken stairs, but that too hard when Grunk carry stuff too. 

>Hole
✓ Something interesting happened!

> GO NORTH
Tunnel and stairs only place that Grunk can go here. Tunnel go east; stairs go up.

>Hole
✓ Something interesting happened!

============================================================
ITERATION 25
============================================================
Room: Hole (ID: 102)
Inventory: empty
Exits: none
Objects: dark, torch, broken stair, tunnel, curly bit, hole, crack

AI analyzing...
Priority: medium
Puzzles detected: ['Climbing the broken stairs while carrying items', "Figuring out what's inside the crack in the ground"]
Suggested commands: ['EXAMINE TORCH', 'EXAMINE CRACK', 'GO EAST', 'EXAMINE STAIRS', 'TAKE TORCH']

> EXAMINE TORCH
Grunk bring torch because Grunk not good at seeing in dark.

One end of torch look black and sooty.

>Hole
✓ Something interesting happened!

> EXAMINE CRACK
Crack wide as Grunk fist, at least at top. It dark, so Grunk not see if anything there inside or how deep crack go.

>Hole
✓ Something interesting happened!

> GO EAST

Fountain Room
All wall in this room glow! It bright, just like day time. Except that instead of sun, it wall that glow. And instead of grass and tree, it square room with four wall. And instead of outside, it all under ground. But beside those thing, it just like it! Tunnel keep going out to east a...

> EXAMINE STAIRS
Grunk confused. Not understand that at all.

>Hole

> TAKE TORCH
Grunk already have that!

>Hole

============================================================
ITERATION 26
============================================================
Room: Hole (ID: 102)
Inventory: empty
Exits: none
Objects: dark, torch, broken stair, tunnel, curly bit, hole, crack

AI analyzing...
Priority: medium
Puzzles detected: ['Determining the purpose or significance of the crack in the ground', 'Interacting with the curtain on the south wall', 'Discovering the relationship between the player character and the pig']
Suggested commands: ['EXAMINE CRACK', 'EXAMINE CURTAIN', 'EXAMINE PIG', 'GO EAST', 'GO WEST', 'GO NORTH', 'GO SOUTHEAST', 'GO SOUTHWEST']

> EXAMINE CRACK
Crack wide as Grunk fist, at least at top. It dark, so Grunk not see if anything there inside or how deep crack go.

>Hole
✓ Something interesting happened!

> EXAMINE CURTAIN
Grunk not see that there.

>Hole

> EXAMINE PIG
Grunk not see that there.

>Hole

> GO EAST

Fountain Room
All wall in this room glow! It bright, just like day time. Except that instead of sun, it wall that glow. And instead of grass and tree, it square room with four wall. And instead of outside, it all under ground. But beside those thing, it just like it! Tunnel keep going out to east a...

> GO WEST
Grunk confused. Not understand that at all.

>Hole

============================================================
ITERATION 27
============================================================
Room: Hole (ID: 102)
Inventory: empty
Exits: none
Objects: dark, torch, broken stair, tunnel, curly bit, hole, crack

AI analyzing...
Priority: medium
Puzzles detected: ['Finding a way to climb out of the hole', 'Investigating the crack in the ground']
Suggested commands: ['EXAMINE TORCH', 'TAKE TORCH', 'EXAMINE CRACK', 'GO WEST', 'GO EAST']

> EXAMINE TORCH
Grunk bring torch because Grunk not good at seeing in dark.

One end of torch look black and sooty.

>Hole
✓ Something interesting happened!

> TAKE TORCH
Grunk already have that!

>Hole

> EXAMINE CRACK
Crack wide as Grunk fist, at least at top. It dark, so Grunk not see if anything there inside or how deep crack go.

>Hole
✓ Something interesting happened!

> GO WEST
Grunk try climbing up broken stairs, but that too hard when Grunk carry stuff too. 

>Hole
✓ Something interesting happened!

> GO EAST

Fountain Room
All wall in this room glow! It bright, just like day time. Except that instead of sun, it wall that glow. And instead of grass and tree, it square room with four wall. And instead of outside, it all under ground. But beside those thing, it just like it! Tunnel keep going out to east a...

============================================================
ITERATION 28
============================================================
Room: Hole (ID: 102)
Inventory: empty
Exits: none
Objects: dark, torch, broken stair, tunnel, curly bit, hole, crack

AI analyzing...
Priority: medium
Puzzles detected: ['The broken stairs prevent Grunk from climbing up, so there may be a way to repair or bypass them.', 'The fountain is described as not having any water, which could be a clue that something is missing or needs to be done to activate it.']
Suggested commands: ['EXAMINE CRACK', 'EXAMINE FOUNTAIN', 'EXAMINE CURTAIN', 'GO NORTH', 'GO SOUTHEAST', 'GO SOUTHWEST']

> EXAMINE CRACK
Grunk confused. Not understand that at all.

>Hole

> EXAMINE FOUNTAIN
Grunk not see that there.

>Hole

> EXAMINE CURTAIN
Grunk not see that there.

>Hole

> GO NORTH
Tunnel and stairs only place that Grunk can go here. Tunnel go east; stairs go up.

>Hole
✓ Something interesting happened!

> GO SOUTHEAST
Tunnel and stairs only place that Grunk can go here. Tunnel go east; stairs go up.

>Hole
✓ Something interesting happened!

============================================================
ITERATION 29
============================================================
Room: Hole (ID: 102)
Inventory: empty
Exits: none
Objects: dark, torch, broken stair, tunnel, curly bit, hole, crack

AI analyzing...
Priority: medium
Puzzles detected: ['Repairing the broken stairs to climb out of the hole', 'Navigating the dark hole with limited visibility']
Suggested commands: ['EXAMINE TORCH', 'TAKE TORCH', 'GO EAST', 'GO WEST', 'EXAMINE BROKEN STAIRS']

> EXAMINE TORCH
Grunk bring torch because Grunk not good at seeing in dark.

One end of torch look black and sooty.

>Hole
✓ Something interesting happened!

> TAKE TORCH
Grunk already have that!

>Hole

> GO EAST

Fountain Room
All wall in this room glow! It bright, just like day time. Except that instead of sun, it wall that glow. And instead of grass and tree, it square room with four wall. And instead of outside, it all under ground. But beside those thing, it just like it! Tunnel keep going out to east a...

> GO WEST
Grunk confused. Not understand that at all.

>Hole

> EXAMINE BROKEN STAIRS
That where Grunk fall down into hole. Stair go up pretty high. Made of rock, but rock all falling apart, so stair not much good for climbing anymore.

>Hole
✓ Something interesting happened!

============================================================
ITERATION 30
============================================================
Room: Hole (ID: 102)
Inventory: empty
Exits: none
Objects: dark, torch, broken stair, tunnel, curly bit, hole, crack

AI analyzing...
Priority: medium
Puzzles detected: ['The broken stairs seem to be an obstacle preventing the player from escaping the hole. Fixing or bypassing the stairs may be a puzzle to solve.', 'The empty fountain in the Fountain Room may be a clue or hint towards a puzzle to be solved.']
Suggested commands: ['EXAMINE CRACK', 'EXAMINE CURTAIN', 'GO NORTH', 'GO SOUTHEAST', 'GO SOUTHWEST']

> EXAMINE CRACK
Crack wide as Grunk fist, at least at top. It dark, so Grunk not see if anything there inside or how deep crack go.

>Hole
✓ Something interesting happened!

> EXAMINE CURTAIN
Grunk not see that there.

>Hole

> GO NORTH
Tunnel and stairs only place that Grunk can go here. Tunnel go east; stairs go up.

>Hole
✓ Something interesting happened!

> GO SOUTHEAST
Tunnel and stairs only place that Grunk can go here. Tunnel go east; stairs go up.

>Hole
✓ Something interesting happened!

> GO SOUTHWEST
Tunnel and stairs only place that Grunk can go here. Tunnel go east; stairs go up.

>Hole
✓ Something interesting happened!

============================================================
ITERATION 31
============================================================
Room: Hole (ID: 102)
Inventory: empty
Exits: none
Objects: dark, torch, broken stair, tunnel, curly bit, hole, crack

AI analyzing...
Priority: medium
Puzzles detected: ['The broken stairs may need to be repaired or an alternative way up must be found.', 'The crack in the ground may hide a secret or lead to another area.']
Suggested commands: ['EXAMINE TORCH', 'TAKE TORCH', 'GO EAST', 'GO UP', 'EXAMINE CRACK']

> EXAMINE TORCH
Grunk bring torch because Grunk not good at seeing in dark.

One end of torch look black and sooty.

>Hole
✓ Something interesting happened!

> TAKE TORCH
Grunk already have that!

>Hole

> GO EAST

Fountain Room
All wall in this room glow! It bright, just like day time. Except that instead of sun, it wall that glow. And instead of grass and tree, it square room with four wall. And instead of outside, it all under ground. But beside those thing, it just like it! Tunnel keep going out to east a...

> GO UP
Grunk confused. Not understand that at all.

>Hole

> EXAMINE CRACK
Crack wide as Grunk fist, at least at top. It dark, so Grunk not see if anything there inside or how deep crack go.

>Hole
✓ Something interesting happened!

============================================================
ITERATION 32
============================================================
Room: Hole (ID: 102)
Inventory: empty
Exits: none
Objects: dark, torch, broken stair, tunnel, curly bit, hole, crack

AI analyzing...
Priority: high
Puzzles detected: ['Escaping the hole', 'Investigating the crack', 'Interacting with the pig or the curtain']
Suggested commands: ['EXAMINE CRACK', 'GO WEST', 'TAKE TORCH', 'EXAMINE PIG', 'EXAMINE CURTAIN']

> EXAMINE CRACK
Crack wide as Grunk fist, at least at top. It dark, so Grunk not see if anything there inside or how deep crack go.

>Hole
✓ Something interesting happened!

> GO WEST
Grunk try climbing up broken stairs, but that too hard when Grunk carry stuff too. 

>Hole
✓ Something interesting happened!

> TAKE TORCH
Grunk already have that!

>Hole

> EXAMINE PIG
Grunk not see that there.

>Hole

> EXAMINE CURTAIN
Grunk not see that there.

>Hole

============================================================
ITERATION 33
============================================================
Room: Hole (ID: 102)
Inventory: empty
Exits: none
Objects: dark, torch, broken stair, tunnel, curly bit, hole, crack

AI analyzing...
Priority: high
Puzzles detected: ['Climbing the broken stairs to get out of the hole', 'Exploring the tunnel to the east and seeing where it leads']
Suggested commands: ['EXAMINE TUNNEL', 'EXAMINE CRACK', 'GO EAST', 'EXAMINE STAIRS', 'CLIMB STAIRS']

> EXAMINE TUNNEL
Hmm, look like there curly bit carved all around edge where tunnel start. Maybe some person think this place special.

>Hole
✓ Something interesting happened!

> EXAMINE CRACK
Crack wide as Grunk fist, at least at top. It dark, so Grunk not see if anything there inside or how deep crack go.

>Hole
✓ Something interesting happened!

> GO EAST

Fountain Room
All wall in this room glow! It bright, just like day time. Except that instead of sun, it wall that glow. And instead of grass and tree, it square room with four wall. And instead of outside, it all under ground. But beside those thing, it just like it! Tunnel keep going out to east a...

> EXAMINE STAIRS
Grunk confused. Not understand that at all.

>Hole

> CLIMB STAIRS
Grunk try climbing up broken stairs, but that too hard when Grunk carry stuff too. 

>Hole
✓ Something interesting happened!

============================================================
ITERATION 34
============================================================
Room: Hole (ID: 102)
Inventory: empty
Exits: none
Objects: dark, torch, broken stair, tunnel, curly bit, hole, crack

AI analyzing...
Priority: medium
Puzzles detected: ['The broken stairs seem to be an obstacle preventing the player from easily exiting the Hole. There may be a way to either repair the stairs or find an alternative route out.', 'The crack in the ground could be hiding something or lead to another area, and may require further investigation.']
Suggested commands: ['EXAMINE TORCH', 'TAKE TORCH', 'EXAMINE CRACK', 'EXAMINE CURTAIN', 'EXAMINE PIG']

> EXAMINE TORCH
Grunk bring torch because Grunk not good at seeing in dark.

One end of torch look black and sooty.

>Hole
✓ Something interesting happened!

> TAKE TORCH
Grunk already have that!

>Hole

> EXAMINE CRACK
Crack wide as Grunk fist, at least at top. It dark, so Grunk not see if anything there inside or how deep crack go.

>Hole
✓ Something interesting happened!

> EXAMINE CURTAIN
Grunk not see that there.

>Hole

> EXAMINE PIG
Grunk not see that there.

>Hole

============================================================
ITERATION 35
============================================================
Room: Hole (ID: 102)
Inventory: empty
Exits: none
Objects: dark, torch, broken stair, tunnel, curly bit, hole, crack

AI analyzing...
Priority: medium
Puzzles detected: ['Crossing the crack in the ground', 'Navigating the broken stairs']
Suggested commands: ['EXAMINE CRACK', 'EXAMINE BROKEN STAIR', 'GO EAST', 'CLIMB BROKEN STAIR', 'JUMP ACROSS CRACK']

> EXAMINE CRACK
Crack wide as Grunk fist, at least at top. It dark, so Grunk not see if anything there inside or how deep crack go.

>Hole
✓ Something interesting happened!

> EXAMINE BROKEN STAIR
That where Grunk fall down into hole. Stair go up pretty high. Made of rock, but rock all falling apart, so stair not much good for climbing anymore.

>Hole
✓ Something interesting happened!

> GO EAST

Fountain Room
All wall in this room glow! It bright, just like day time. Except that instead of sun, it wall that glow. And instead of grass and tree, it square room with four wall. And instead of outside, it all under ground. But beside those thing, it just like it! Tunnel keep going out to east a...

> CLIMB BROKEN STAIR
Grunk confused. Not understand that at all.

>Hole

> JUMP ACROSS CRACK
Grunk not see that there.

>Hole

============================================================
ITERATION 36
============================================================
Room: Hole (ID: 102)
Inventory: empty
Exits: none
Objects: dark, torch, broken stair, tunnel, curly bit, hole, crack

AI analyzing...
Priority: medium
Puzzles detected: ['Climbing the broken stairs or jumping across the crack may be a puzzle to overcome', 'The curtain in the Fountain Room could hide something important']
Suggested commands: ['EXAMINE TORCH', 'TAKE TORCH', 'GO EAST', 'GO WEST', 'EXAMINE CURTAIN', 'EXAMINE PIG']

> EXAMINE TORCH
Grunk bring torch because Grunk not good at seeing in dark.

One end of torch look black and sooty.

>Hole
✓ Something interesting happened!

> TAKE TORCH
Grunk already have that!

>Hole

> GO EAST

Fountain Room
All wall in this room glow! It bright, just like day time. Except that instead of sun, it wall that glow. And instead of grass and tree, it square room with four wall. And instead of outside, it all under ground. But beside those thing, it just like it! Tunnel keep going out to east a...

> GO WEST
Grunk confused. Not understand that at all.

>Hole

> EXAMINE CURTAIN
Grunk not see that there.

>Hole

============================================================
ITERATION 37
============================================================
Room: Hole (ID: 102)
Inventory: empty
Exits: none
Objects: dark, torch, broken stair, tunnel, curly bit, hole, crack

AI analyzing...
Priority: medium
Puzzles detected: ['Fixing the broken stairs to exit the hole', 'Interacting with the pig or curtain to progress further']
Suggested commands: ['EXAMINE CRACK', 'EXAMINE STAIRS', 'GO WEST', 'EXAMINE PIG', 'EXAMINE CURTAIN']

> EXAMINE CRACK
Crack wide as Grunk fist, at least at top. It dark, so Grunk not see if anything there inside or how deep crack go.

>Hole
✓ Something interesting happened!

> EXAMINE STAIRS
That where Grunk fall down into hole. Stair go up pretty high. Made of rock, but rock all falling apart, so stair not much good for climbing anymore.

>Hole
✓ Something interesting happened!

> GO WEST
Grunk try climbing up broken stairs, but that too hard when Grunk carry stuff too. 

>Hole
✓ Something interesting happened!

> EXAMINE PIG
Grunk not see that there.

>Hole

> EXAMINE CURTAIN
Grunk not see that there.

>Hole

============================================================
ITERATION 38
============================================================
Room: Hole (ID: 102)
Inventory: empty
Exits: none
Objects: dark, torch, broken stair, tunnel, curly bit, hole, crack

AI analyzing...
Priority: medium
Puzzles detected: ['Climbing the broken stairs', 'Exploring the crack in the ground']
Suggested commands: ['EXAMINE TORCH', 'TAKE TORCH', 'GO EAST', 'EXAMINE CRACK', 'CLIMB STAIRS']

> EXAMINE TORCH
Grunk bring torch because Grunk not good at seeing in dark.

One end of torch look black and sooty.

>Hole
✓ Something interesting happened!

> TAKE TORCH
Grunk already have that!

>Hole

> GO EAST

Fountain Room
All wall in this room glow! It bright, just like day time. Except that instead of sun, it wall that glow. And instead of grass and tree, it square room with four wall. And instead of outside, it all under ground. But beside those thing, it just like it! Tunnel keep going out to east a...

> EXAMINE CRACK
Grunk confused. Not understand that at all.

>Hole

> CLIMB STAIRS
Grunk try climbing up broken stairs, but that too hard when Grunk carry stuff too. 

>Hole
✓ Something interesting happened!

============================================================
ITERATION 39
============================================================
Room: Hole (ID: 102)
Inventory: empty
Exits: none
Objects: dark, torch, broken stair, tunnel, curly bit, hole, crack

AI analyzing...
Priority: medium
Puzzles detected: ['How to climb out of the hole', 'What is the purpose of the fountain and the glowing walls', 'What is the significance of the pig and the curtain']
Suggested commands: ['EXAMINE STAIRS', 'EXAMINE CRACK', 'GO WEST', 'EXAMINE PIG', 'EXAMINE CURTAIN']

> EXAMINE STAIRS
That where Grunk fall down into hole. Stair go up pretty high. Made of rock, but rock all falling apart, so stair not much good for climbing anymore.

>Hole
✓ Something interesting happened!

> EXAMINE CRACK
Crack wide as Grunk fist, at least at top. It dark, so Grunk not see if anything there inside or how deep crack go.

>Hole
✓ Something interesting happened!

> GO WEST
Grunk try climbing up broken stairs, but that too hard when Grunk carry stuff too. 

>Hole
✓ Something interesting happened!

> EXAMINE PIG
Grunk not see that there.

>Hole

> EXAMINE CURTAIN
Grunk not see that there.

>Hole

============================================================
ITERATION 40
============================================================
Room: Hole (ID: 102)
Inventory: empty
Exits: none
Objects: dark, torch, broken stair, tunnel, curly bit, hole, crack

AI analyzing...
Priority: high
Puzzles detected: ['How to climb out of the hole, given the broken stairs?', 'What lies within the crack in the ground?']
Suggested commands: ['EXAMINE TORCH', 'TAKE TORCH', 'GO EAST', 'EXAMINE CRACK', 'EXAMINE HOLE']

> EXAMINE TORCH
Grunk bring torch because Grunk not good at seeing in dark.

One end of torch look black and sooty.

>Hole
✓ Something interesting happened!

> TAKE TORCH
Grunk already have that!

>Hole

> GO EAST

Fountain Room
All wall in this room glow! It bright, just like day time. Except that instead of sun, it wall that glow. And instead of grass and tree, it square room with four wall. And instead of outside, it all under ground. But beside those thing, it just like it! Tunnel keep going out to east a...

> EXAMINE CRACK
Grunk confused. Not understand that at all.

>Hole

> EXAMINE HOLE
Top of hole way up at top of stair. That pretty high up.

>Hole
✓ Something interesting happened!

============================================================
ITERATION 41
============================================================
Room: Hole (ID: 102)
Inventory: empty
Exits: none
Objects: dark, torch, broken stair, tunnel, curly bit, hole, crack

AI analyzing...
Priority: medium
Puzzles detected: ['The broken stairs may need to be repaired to get out of the hole', 'The crack in the ground could be a potential hazard or something to interact with']
Suggested commands: ['EXAMINE STAIRS', 'EXAMINE CRACK', 'EXAMINE PIG', 'EXAMINE CURTAIN', 'GO EAST']

> EXAMINE STAIRS
That where Grunk fall down into hole. Stair go up pretty high. Made of rock, but rock all falling apart, so stair not much good for climbing anymore.

>Hole
✓ Something interesting happened!

> EXAMINE CRACK
Crack wide as Grunk fist, at least at top. It dark, so Grunk not see if anything there inside or how deep crack go.

>Hole
✓ Something interesting happened!

> EXAMINE PIG
Grunk not see that there.

>Hole

> EXAMINE CURTAIN
Grunk not see that there.

>Hole

> GO EAST

Fountain Room
All wall in this room glow! It bright, just like day time. Except that instead of sun, it wall that glow. And instead of grass and tree, it square room with four wall. And instead of outside, it all under ground. But beside those thing, it just like it! Tunnel keep going out to east a...

============================================================
ITERATION 42
============================================================
Room: Hole (ID: 102)
Inventory: empty
Exits: none
Objects: dark, torch, broken stair, tunnel, curly bit, hole, crack

AI analyzing...
Priority: medium
Puzzles detected: ['The broken stairs may need to be repaired or an alternative way out of the hole needs to be found.', 'The lack of water in the fountain may be a clue to a puzzle or an important item.']
Suggested commands: ['EXAMINE TORCH', 'TAKE TORCH', 'GO EAST', 'EXAMINE PIG', 'EXAMINE CURTAIN']

> EXAMINE TORCH
Grunk confused. Not understand that at all.

>Hole

> TAKE TORCH
Grunk already have that!

>Hole

> GO EAST

Fountain Room
All wall in this room glow! It bright, just like day time. Except that instead of sun, it wall that glow. And instead of grass and tree, it square room with four wall. And instead of outside, it all under ground. But beside those thing, it just like it! Tunnel keep going out to east a...

> EXAMINE PIG
Grunk confused. Not understand that at all.

>Hole

> EXAMINE CURTAIN
Grunk not see that there.

>Hole

No interesting AI suggestions. Trying basic directions...

============================================================
ITERATION 43
============================================================
Room: Hole (ID: 102)
Inventory: empty
Exits: none
Objects: dark, torch, broken stair, tunnel, curly bit, hole, crack

AI analyzing...
Priority: medium
Puzzles detected: ['Figuring out how to climb out of the hole, potentially using the broken stairs or another method', 'Determining the purpose of the fountain and how to make it work']
Suggested commands: ['examine torch', 'take torch', 'examine crack', 'examine stairs', 'examine fountain']

> examine torch
Grunk bring torch because Grunk not good at seeing in dark.

One end of torch look black and sooty.

>Hole
✓ Something interesting happened!

> take torch
Grunk already have that!

>Hole

> examine crack
Crack wide as Grunk fist, at least at top. It dark, so Grunk not see if anything there inside or how deep crack go.

>Hole
✓ Something interesting happened!

> examine stairs
That where Grunk fall down into hole. Stair go up pretty high. Made of rock, but rock all falling apart, so stair not much good for climbing anymore.

>Hole
✓ Something interesting happened!

> examine fountain
Grunk not see that there.

>Hole

============================================================
ITERATION 44
============================================================
Room: Hole (ID: 102)
Inventory: empty
Exits: none
Objects: dark, torch, broken stair, tunnel, curly bit, hole, crack

AI analyzing...
Priority: medium
Puzzles detected: ['Crossing the crack in the ground', 'Climbing the broken stairs']
Suggested commands: ['examine crack', 'examine stairs', 'go east', 'climb stairs', 'jump across crack']

> examine crack
Crack wide as Grunk fist, at least at top. It dark, so Grunk not see if anything there inside or how deep crack go.

>Hole
✓ Something interesting happened!

> examine stairs
That where Grunk fall down into hole. Stair go up pretty high. Made of rock, but rock all falling apart, so stair not much good for climbing anymore.

>Hole
✓ Something interesting happened!

> go east

Fountain Room
All wall in this room glow! It bright, just like day time. Except that instead of sun, it wall that glow. And instead of grass and tree, it square room with four wall. And instead of outside, it all under ground. But beside those thing, it just like it! Tunnel keep going out to east a...

> climb stairs
Grunk confused. Not understand that at all.

>Hole

> jump across crack
Grunk not see that there.

>Hole

============================================================
ITERATION 45
============================================================
Room: Hole (ID: 102)
Inventory: empty
Exits: none
Objects: dark, torch, broken stair, tunnel, curly bit, hole, crack

AI analyzing...
Priority: high
Puzzles detected: ['The crack in the ground may conceal a hidden path or object.', 'The fountain may need to be fixed or interacted with in some way.', 'The curtain on the south wall may hide an important item or reveal a new area.']
Suggested commands: ['examine torch', 'take torch', 'examine crack', 'examine fountain', 'examine curtain', 'go north', 'go southeast', 'go southwest']

> examine torch
Grunk bring torch because Grunk not good at seeing in dark.

One end of torch look black and sooty.

>Hole
✓ Something interesting happened!

> take torch
Grunk already have that!

>Hole

> examine crack
Crack wide as Grunk fist, at least at top. It dark, so Grunk not see if anything there inside or how deep crack go.

>Hole
✓ Something interesting happened!

> examine fountain
Grunk not see that there.

>Hole

> examine curtain
Grunk not see that there.

>Hole

============================================================
ITERATION 46
============================================================
Room: Hole (ID: 102)
Inventory: empty
Exits: none
Objects: dark, torch, broken stair, tunnel, curly bit, hole, crack

AI analyzing...
Priority: medium
Puzzles detected: ['Crossing the crack in the ground', 'Navigating the broken stairs']
Suggested commands: ['examine crack', 'examine tunnel', 'climb stairs', 'go east', 'jump across crack']

> examine crack
Crack wide as Grunk fist, at least at top. It dark, so Grunk not see if anything there inside or how deep crack go.

>Hole
✓ Something interesting happened!

> examine tunnel
Hmm, look like there curly bit carved all around edge where tunnel start. Maybe some person think this place special.

>Hole
✓ Something interesting happened!

> climb stairs
Grunk try climbing up broken stairs, but that too hard when Grunk carry stuff too. 

>Hole
✓ Something interesting happened!

> go east

Fountain Room
All wall in this room glow! It bright, just like day time. Except that instead of sun, it wall that glow. And instead of grass and tree, it square room with four wall. And instead of outside, it all under ground. But beside those thing, it just like it! Tunnel keep going out to east a...

> jump across crack
Grunk confused. Not understand that at all.

>Hole

============================================================
ITERATION 47
============================================================
Room: Hole (ID: 102)
Inventory: empty
Exits: none
Objects: dark, torch, broken stair, tunnel, curly bit, hole, crack

AI analyzing...
Priority: medium
Puzzles detected: ['How to climb out of the hole', 'Solving the purpose of the crack in the ground']
Suggested commands: ['examine torch', 'take torch', 'examine crack', 'examine curtain', 'go north']

> examine torch
Grunk bring torch because Grunk not good at seeing in dark.

One end of torch look black and sooty.

>Hole
✓ Something interesting happened!

> take torch
Grunk already have that!

>Hole

> examine crack
Crack wide as Grunk fist, at least at top. It dark, so Grunk not see if anything there inside or how deep crack go.

>Hole
✓ Something interesting happened!

> examine curtain
Grunk not see that there.

>Hole

> go north
Tunnel and stairs only place that Grunk can go here. Tunnel go east; stairs go up.

>Hole
✓ Something interesting happened!

============================================================
ITERATION 48
============================================================
Room: Hole (ID: 102)
Inventory: empty
Exits: none
Objects: dark, torch, broken stair, tunnel, curly bit, hole, crack

AI analyzing...
Priority: medium
Puzzles detected: ['How to safely ascend the broken stairs?', 'What lies at the end of the tunnel?', 'Is there anything of interest within the crack in the ground?']
Suggested commands: ['examine crack', 'examine tunnel', 'climb stairs', 'go east', 'go up']

> examine crack
Crack wide as Grunk fist, at least at top. It dark, so Grunk not see if anything there inside or how deep crack go.

>Hole
✓ Something interesting happened!

> examine tunnel
Hmm, look like there curly bit carved all around edge where tunnel start. Maybe some person think this place special.

>Hole
✓ Something interesting happened!

> climb stairs
Grunk try climbing up broken stairs, but that too hard when Grunk carry stuff too. 

>Hole
✓ Something interesting happened!

> go east

Fountain Room
All wall in this room glow! It bright, just like day time. Except that instead of sun, it wall that glow. And instead of grass and tree, it square room with four wall. And instead of outside, it all under ground. But beside those thing, it just like it! Tunnel keep going out to east a...

> go up
Grunk confused. Not understand that at all.

>Hole

============================================================
ITERATION 49
============================================================
Room: Hole (ID: 102)
Inventory: empty
Exits: none
Objects: dark, torch, broken stair, tunnel, curly bit, hole, crack

AI analyzing...
Priority: medium
Puzzles detected: ['The broken stairs prevent the player from climbing up and out of the hole. The crack in the ground may lead to something interesting or offer a way to bypass the stairs. The fountain is empty, which could indicate a puzzle to restore it.']
Suggested commands: ['examine torch', 'take torch', 'examine crack', 'examine fountain', 'examine curtain', 'go north', 'go southeast', 'go southwest']

> examine torch
Grunk bring torch because Grunk not good at seeing in dark.

One end of torch look black and sooty.

>Hole
✓ Something interesting happened!

> take torch
Grunk already have that!

>Hole

> examine crack
Crack wide as Grunk fist, at least at top. It dark, so Grunk not see if anything there inside or how deep crack go.

>Hole
✓ Something interesting happened!

> examine fountain
Grunk not see that there.

>Hole

> examine curtain
Grunk not see that there.

>Hole

============================================================
ITERATION 50
============================================================
Room: Hole (ID: 102)
Inventory: empty
Exits: none
Objects: dark, torch, broken stair, tunnel, curly bit, hole, crack

AI analyzing...
Priority: medium
Puzzles detected: ['The stairs are broken, so the player may need to find a way to repair or bypass them to reach the outside.']
Suggested commands: ['examine crack', 'go east', 'examine stairs', 'climb stairs', 'examine tunnel']

> examine crack
Crack wide as Grunk fist, at least at top. It dark, so Grunk not see if anything there inside or how deep crack go.

>Hole
✓ Something interesting happened!

> go east

Fountain Room
All wall in this room glow! It bright, just like day time. Except that instead of sun, it wall that glow. And instead of grass and tree, it square room with four wall. And instead of outside, it all under ground. But beside those thing, it just like it! Tunnel keep going out to east a...

> examine stairs
Grunk confused. Not understand that at all.

>Hole

> climb stairs
Grunk try climbing up broken stairs, but that too hard when Grunk carry stuff too. 

>Hole
✓ Something interesting happened!

> examine tunnel
Hmm, look like there curly bit carved all around edge where tunnel start. Maybe some person think this place special.

>Hole
✓ Something interesting happened!

============================================================
SOLUTION SUMMARY
============================================================
Rooms discovered: 2
Commands in solution: 123

Solution path:
  1. EXAMINE FIELD
  2. EXAMINE FOREST
  3. GO EAST
  4. GO NORTH
  5. EXAMINE MOON
  6. GO SOUTH
  7. EXAMINE FOREST
  8. GO EAST
  9. GO NORTH
  10. LISTEN
  11. GO NORTHEAST
  12. EXAMINE TORCH
  13. EXAMINE CRACK
  14. EXAMINE STAIRS
  15. CLIMB STAIRS
  16. EXAMINE CRACK
  17. EXAMINE METAL THING
  18. CLIMB STAIRS
  19. EXAMINE TUNNEL
  20. EXAMINE TUNNEL
  21. EXAMINE CRACK
  22. EXAMINE TORCH
  23. SEARCH HOLE
  24. EXAMINE CRACK
  25. EXAMINE STAIRS
  26. EXAMINE TORCH
  27. GO WEST
  28. EXAMINE CRACK
  29. EXAMINE CRACK
  30. EXAMINE BROKEN STAIR
  31. EXAMINE TUNNEL
  32. SEARCH CRACK
  33. GO NORTH
  34. EXAMINE TORCH
  35. SEARCH CRACK
  36. EXAMINE CRACK
  37. EXAMINE STAIRS
  38. EXAMINE CRACK
  39. EXAMINE TUNNEL
  40. EXAMINE STAIRS
  41. EXAMINE CRACK
  42. GO NORTH
  43. GO SOUTHEAST
  44. GO SOUTHWEST
  45. EXAMINE TORCH
  46. EXAMINE CRACK
  47. EXAMINE CRACK
  48. GO WEST
  49. EXAMINE TORCH
  50. EXAMINE CRACK
  51. EXAMINE CRACK
  52. GO WEST
  53. EXAMINE STAIRS
  54. EXAMINE TORCH
  55. EXAMINE TUNNEL
  56. EXAMINE STAIRS
  57. EXAMINE CRACK
  58. GO NORTH
  59. GO SOUTHEAST
  60. EXAMINE TORCH
  61. EXAMINE CRACK
  62. EXAMINE CRACK
  63. GO WEST
  64. GO NORTH
  65. EXAMINE TORCH
  66. EXAMINE CRACK
  67. EXAMINE CRACK
  68. EXAMINE TORCH
  69. EXAMINE CRACK
  70. GO WEST
  71. GO NORTH
  72. GO SOUTHEAST
  73. EXAMINE TORCH
  74. EXAMINE BROKEN STAIRS
  75. EXAMINE CRACK
  76. GO NORTH
  77. GO SOUTHEAST
  78. GO SOUTHWEST
  79. EXAMINE TORCH
  80. EXAMINE CRACK
  81. EXAMINE CRACK
  82. GO WEST
  83. EXAMINE TUNNEL
  84. EXAMINE CRACK
  85. CLIMB STAIRS
  86. EXAMINE TORCH
  87. EXAMINE CRACK
  88. EXAMINE CRACK
  89. EXAMINE BROKEN STAIR
  90. EXAMINE TORCH
  91. EXAMINE CRACK
  92. EXAMINE STAIRS
  93. GO WEST
  94. EXAMINE TORCH
  95. CLIMB STAIRS
  96. EXAMINE STAIRS
  97. EXAMINE CRACK
  98. GO WEST
  99. EXAMINE TORCH
  100. EXAMINE HOLE
  101. EXAMINE STAIRS
  102. EXAMINE CRACK
  103. examine torch
  104. examine crack
  105. examine stairs
  106. examine crack
  107. examine stairs
  108. examine torch
  109. examine crack
  110. examine crack
  111. examine tunnel
  112. climb stairs
  113. examine torch
  114. examine crack
  115. go north
  116. examine crack
  117. examine tunnel
  118. climb stairs
  119. examine torch
  120. examine crack
  121. examine crack
  122. climb stairs
  123. examine tunnel

✓ Solution saved to: lostpig_solution.json

✓ Walkthrough generated: lostpig_solution.json
  Rooms visited: 2
  Commands: 123

STEP 2: Compiling with z2js...
----------------------------------------------------------------------
  Compiling lostpig with z2js...
  ✓ Generated z2js_output/lostpig.js (508,557 bytes)

======================================================================
GAME 4/5: Trinity (Classic Infocom)
File: games/zcode/trinity.z4
======================================================================

STEP 1: Generating walkthrough with AI...
----------------------------------------------------------------------
Loading games/zcode/trinity.z4...
============================================================
GAME START
============================================================

[Screen too narrow.]


Using Anthropic Claude for AI assistance...

============================================================
ITERATION 1
============================================================
Room: Paved Road (ID: 293)
Inventory: empty
Exits: none
Objects: none

AI analyzing...
Priority: medium
Suggested commands: ['look', 'examine', 'go north', 'go south', 'go east', 'go west']

> look


> examine


> go north


> go south


> go east


No interesting AI suggestions. Trying basic directions...

============================================================
ITERATION 2
============================================================
Room: Paved Road (ID: 293)
Inventory: empty
Exits: none
Objects: none

AI analyzing...
Priority: medium
Suggested commands: ['examine', 'look', 'inventory', 'search', 'help']

> examine


> look


> inventory


> search


> help


No interesting AI suggestions. Trying basic directions...

============================================================
ITERATION 3
============================================================
Room: Paved Road (ID: 293)
Inventory: empty
Exits: none
Objects: none

AI analyzing...
Priority: low
Suggested commands: ['look', 'examine', 'search', 'map', 'inventory']

> look


> examine


> search


> map


> inventory


No interesting AI suggestions. Trying basic directions...

============================================================
ITERATION 4
============================================================
Room: Paved Road (ID: 293)
Inventory: empty
Exits: none
Objects: none

AI analyzing...
Priority: medium
Puzzles detected: ['screen size/view adjustment']
Suggested commands: ['examine', 'look around', 'search', 'inventory', 'help']

> examine


> look around


> search


> inventory


> help


No interesting AI suggestions. Trying basic directions...

============================================================
ITERATION 5
============================================================
Room: Paved Road (ID: 293)
Inventory: empty
Exits: none
Objects: none

AI analyzing...
Priority: high
Suggested commands: ['look', 'examine', 'take inventory', 'go north', 'go south']

> look


> examine


> take inventory


> go north


> go south


No interesting AI suggestions. Trying basic directions...

============================================================
ITERATION 6
============================================================
Room: Paved Road (ID: 293)
Inventory: empty
Exits: none
Objects: none

AI analyzing...
Priority: medium
Suggested commands: ['look', 'examine', 'inventory', 'north', 'south', 'east', 'west']

> look


> examine


> inventory


> north


> south


No interesting AI suggestions. Trying basic directions...

============================================================
ITERATION 7
============================================================
Room: Paved Road (ID: 293)
Inventory: empty
Exits: none
Objects: none

AI analyzing...
Priority: medium
Suggested commands: ['north', 'examine', 'take', 'inventory']

> north


> examine


> take


> inventory


No interesting AI suggestions. Trying basic directions...

============================================================
ITERATION 8
============================================================
Room: Paved Road (ID: 293)
Inventory: empty
Exits: none
Objects: none

AI analyzing...
Priority: medium
Suggested commands: ['look', 'examine', 'search', 'inventory', 'help', 'north']

> look


> examine


> search


> inventory


> help


No interesting AI suggestions. Trying basic directions...

============================================================
ITERATION 9
============================================================
Room: Paved Road (ID: 293)
Inventory: empty
Exits: none
Objects: none

AI analyzing...
Priority: high
Suggested commands: ['look', 'examine', 'search', 'inventory', 'help']

> look


> examine


> search


> inventory


> help


No interesting AI suggestions. Trying basic directions...

============================================================
ITERATION 10
============================================================
Room: Paved Road (ID: 293)
Inventory: empty
Exits: none
Objects: none

AI analyzing...
Priority: high
Suggested commands: ['look', 'examine', 'search', 'take inventory', 'go north']

> look


> examine


> search


> take inventory


> go north


No interesting AI suggestions. Trying basic directions...

============================================================
ITERATION 11
============================================================
Room: Paved Road (ID: 293)
Inventory: empty
Exits: none
Objects: none

AI analyzing...
Priority: medium
Suggested commands: ['look', 'examine', 'search', 'inventory', 'go north', 'go south', 'go east', 'go west']

> look


> examine


> search


> inventory


> go north


No interesting AI suggestions. Trying basic directions...

============================================================
ITERATION 12
============================================================
Room: Paved Road (ID: 293)
Inventory: empty
Exits: none
Objects: none

AI analyzing...
Priority: high
Suggested commands: ['look', 'examine', 'search', 'inventory', 'help']

> look


> examine


> search


> inventory


> help


No interesting AI suggestions. Trying basic directions...

============================================================
ITERATION 13
============================================================
Room: Paved Road (ID: 293)
Inventory: empty
Exits: none
Objects: none

AI analyzing...
Priority: high
Suggested commands: ['examine', 'look', 'inventory', 'help', 'version']

> examine


> look


> inventory


> help


> version


No interesting AI suggestions. Trying basic directions...

============================================================
ITERATION 14
============================================================
Room: Paved Road (ID: 293)
Inventory: empty
Exits: none
Objects: none

AI analyzing...
Priority: high
Suggested commands: ['n', 's', 'e', 'w', 'look', 'examine']

> n


> s


> e


> w


> look


No interesting AI suggestions. Trying basic directions...

============================================================
ITERATION 15
============================================================
Room: Paved Road (ID: 293)
Inventory: empty
Exits: none
Objects: none

AI analyzing...
Priority: medium
Suggested commands: ['n', 'ne', 'nw', 'examine room', 'examine exits']

> n


> ne


> nw


> examine room


> examine exits


No interesting AI suggestions. Trying basic directions...

============================================================
ITERATION 16
============================================================
Room: Paved Road (ID: 293)
Inventory: empty
Exits: none
Objects: none

AI analyzing...
Priority: medium
Suggested commands: ['look', 'examine', 'search', 'inventory', 'help']

> look


> examine


> search


> inventory


> help


No interesting AI suggestions. Trying basic directions...

============================================================
ITERATION 17
============================================================
Room: Paved Road (ID: 293)
Inventory: empty
Exits: none
Objects: none

AI analyzing...
Priority: medium
Suggested commands: ['look', 'examine', 'search', 'inventory', 'north', 'south', 'east', 'west']

> look


> examine


> search


> inventory


> north


No interesting AI suggestions. Trying basic directions...

============================================================
ITERATION 18
============================================================
Room: Paved Road (ID: 293)
Inventory: empty
Exits: none
Objects: none

AI analyzing...
Priority: high
Suggested commands: ['look', 'examine room', 'search', 'inventory', 'help']

> look


> examine room


> search


> inventory


> help


No interesting AI suggestions. Trying basic directions...

============================================================
ITERATION 19
============================================================
Room: Paved Road (ID: 293)
Inventory: empty
Exits: none
Objects: none

AI analyzing...
Priority: medium
Suggested commands: ['n', 's', 'e', 'w', 'inventory', 'examine room', 'examine exits']

> n


> s


> e


> w


> inventory


No interesting AI suggestions. Trying basic directions...

============================================================
ITERATION 20
============================================================
Room: Paved Road (ID: 293)
Inventory: empty
Exits: none
Objects: none

AI analyzing...
Priority: medium
Suggested commands: ['look', 'examine', 'take inventory', 'north', 'south', 'east', 'west']

> look


> examine


> take inventory


> north


> south


No interesting AI suggestions. Trying basic directions...

============================================================
ITERATION 21
============================================================
Room: Paved Road (ID: 293)
Inventory: empty
Exits: none
Objects: none

AI analyzing...
Priority: medium
Suggested commands: ['look', 'examine', 'go north', 'go south', 'go east', 'go west']

> look


> examine


> go north


> go south


> go east


No interesting AI suggestions. Trying basic directions...

============================================================
ITERATION 22
============================================================
Room: Paved Road (ID: 293)
Inventory: empty
Exits: none
Objects: none

AI analyzing...
Priority: medium
Suggested commands: ['look', 'examine', 'take', 'go north', 'go south']

> look


> examine


> take


> go north


> go south


No interesting AI suggestions. Trying basic directions...

============================================================
ITERATION 23
============================================================
Room: Paved Road (ID: 293)
Inventory: empty
Exits: none
Objects: none

AI analyzing...
Priority: medium
Suggested commands: ['look', 'examine', 'search', 'inventory', 'help', 'map']

> look


> examine


> search


> inventory


> help


No interesting AI suggestions. Trying basic directions...

============================================================
ITERATION 24
============================================================
Room: Paved Road (ID: 293)
Inventory: empty
Exits: none
Objects: none

AI analyzing...
Priority: high
Suggested commands: ['look', 'examine', 'search', 'inventory', 'help']

> look


> examine


> search


> inventory


> help


No interesting AI suggestions. Trying basic directions...

============================================================
ITERATION 25
============================================================
Room: Paved Road (ID: 293)
Inventory: empty
Exits: none
Objects: none

AI analyzing...
Priority: medium
Suggested commands: ['look', 'examine', 'search', 'inventory', 'north', 'south', 'east', 'west']

> look


> examine


> search


> inventory


> north


No interesting AI suggestions. Trying basic directions...

============================================================
ITERATION 26
============================================================
Room: Paved Road (ID: 293)
Inventory: empty
Exits: none
Objects: none

AI analyzing...
Priority: high
Suggested commands: ['inventory', 'examine room', 'look', 'examine exits', 'help']

> inventory


> examine room


> look


> examine exits


> help


No interesting AI suggestions. Trying basic directions...

============================================================
ITERATION 27
============================================================
Room: Paved Road (ID: 293)
Inventory: empty
Exits: none
Objects: none

AI analyzing...
Priority: high
Suggested commands: ['look', 'examine', 'inventory', 'north']

> look


> examine


> inventory


> north


No interesting AI suggestions. Trying basic directions...

============================================================
ITERATION 28
============================================================
Room: Paved Road (ID: 293)
Inventory: empty
Exits: none
Objects: none

AI analyzing...
Priority: low
Suggested commands: ['look', 'examine', 'inventory', 'help', 'map']

> look


> examine


> inventory


> help


> map


No interesting AI suggestions. Trying basic directions...

============================================================
ITERATION 29
============================================================
Room: Paved Road (ID: 293)
Inventory: empty
Exits: none
Objects: none

AI analyzing...
Priority: medium
Suggested commands: ['n', 's', 'e', 'w', 'inventory', 'look']

> n


> s


> e


> w


> inventory


No interesting AI suggestions. Trying basic directions...

============================================================
ITERATION 30
============================================================
Room: Paved Road (ID: 293)
Inventory: empty
Exits: none
Objects: none

AI analyzing...
Priority: medium
Suggested commands: ['n', 's', 'e', 'w', 'inventory', 'look']

> n


> s


> e


> w


> inventory


No interesting AI suggestions. Trying basic directions...

============================================================
ITERATION 31
============================================================
Room: Paved Road (ID: 293)
Inventory: empty
Exits: none
Objects: none

AI analyzing...
Priority: medium
Suggested commands: ['look', 'examine', 'inventory', 'n', 's', 'e', 'w']

> look


> examine


> inventory


> n


> s


No interesting AI suggestions. Trying basic directions...

============================================================
ITERATION 32
============================================================
Room: Paved Road (ID: 293)
Inventory: empty
Exits: none
Objects: none

AI analyzing...
Priority: medium
Suggested commands: ['look', 'examine', 'search', 'inventory', 'help', 'save']

> look


> examine


> search


> inventory


> help


No interesting AI suggestions. Trying basic directions...

============================================================
ITERATION 33
============================================================
Room: Paved Road (ID: 293)
Inventory: empty
Exits: none
Objects: none

AI analyzing...
Priority: high
Suggested commands: ['look', 'examine', 'inventory', 'search']

> look


> examine


> inventory


> search


No interesting AI suggestions. Trying basic directions...

============================================================
ITERATION 34
============================================================
Room: Paved Road (ID: 293)
Inventory: empty
Exits: none
Objects: none

AI analyzing...
Priority: medium
Suggested commands: ['look', 'examine', 'inventory', 'north', 'south', 'east', 'west']

> look


> examine


> inventory


> north


> south


No interesting AI suggestions. Trying basic directions...

============================================================
ITERATION 35
============================================================
Room: Paved Road (ID: 293)
Inventory: empty
Exits: none
Objects: none

AI analyzing...
Priority: high
Suggested commands: ['north', 'examine', 'search', 'get']

> north


> examine


> search


> get


No interesting AI suggestions. Trying basic directions...

============================================================
ITERATION 36
============================================================
Room: Paved Road (ID: 293)
Inventory: empty
Exits: none
Objects: none

AI analyzing...
Priority: medium
Suggested commands: ['look', 'examine', 'inventory', 'north', 'south', 'east', 'west']

> look


> examine


> inventory


> north


> south


No interesting AI suggestions. Trying basic directions...

============================================================
ITERATION 37
============================================================
Room: Paved Road (ID: 293)
Inventory: empty
Exits: none
Objects: none

AI analyzing...
Priority: medium
Suggested commands: ['look', 'examine', 'inventory', 'north', 'south', 'east', 'west']

> look


> examine


> inventory


> north


> south


No interesting AI suggestions. Trying basic directions...

============================================================
ITERATION 38
============================================================
Room: Paved Road (ID: 293)
Inventory: empty
Exits: none
Objects: none

AI analyzing...
Priority: high
Suggested commands: ['look', 'examine', 'search', 'inventory', 'map']

> look


> examine


> search


> inventory


> map


No interesting AI suggestions. Trying basic directions...

============================================================
ITERATION 39
============================================================
Room: Paved Road (ID: 293)
Inventory: empty
Exits: none
Objects: none

AI analyzing...
Priority: medium
Suggested commands: ['search', 'examine', 'look', 'inventory', 'help', 'directions']

> search


> examine


> look


> inventory


> help


No interesting AI suggestions. Trying basic directions...

============================================================
ITERATION 40
============================================================
Room: Paved Road (ID: 293)
Inventory: empty
Exits: none
Objects: none

AI analyzing...
Priority: medium
Suggested commands: ['look', 'examine', 'take inventory', 'search', 'go north']

> look


> examine


> take inventory


> search


> go north


No interesting AI suggestions. Trying basic directions...

============================================================
ITERATION 41
============================================================
Room: Paved Road (ID: 293)
Inventory: empty
Exits: none
Objects: none

AI analyzing...
Priority: medium
Suggested commands: ['look', 'examine', 'search', 'inventory', 'north']

> look


> examine


> search


> inventory


> north


No interesting AI suggestions. Trying basic directions...

============================================================
ITERATION 42
============================================================
Room: Paved Road (ID: 293)
Inventory: empty
Exits: none
Objects: none

AI analyzing...
Priority: medium
Suggested commands: ['look', 'examine', 'search', 'inventory', 'help', 'north']

> look


> examine


> search


> inventory


> help


No interesting AI suggestions. Trying basic directions...

============================================================
ITERATION 43
============================================================
Room: Paved Road (ID: 293)
Inventory: empty
Exits: none
Objects: none

AI analyzing...
Priority: medium
Suggested commands: ['look', 'examine', 'inventory', 'north', 'search']

> look


> examine


> inventory


> north


> search


No interesting AI suggestions. Trying basic directions...

============================================================
ITERATION 44
============================================================
Room: Paved Road (ID: 293)
Inventory: empty
Exits: none
Objects: none

AI analyzing...
Priority: medium
Suggested commands: ['look', 'examine', 'search', 'take inventory', 'north', 'enter']

> look


> examine


> search


> take inventory


> north


No interesting AI suggestions. Trying basic directions...

============================================================
ITERATION 45
============================================================
Room: Paved Road (ID: 293)
Inventory: empty
Exits: none
Objects: none

AI analyzing...
Priority: high
Suggested commands: ['examine', 'look', 'inventory', 'take', 'search']

> examine


> look


> inventory


> take


> search


No interesting AI suggestions. Trying basic directions...

============================================================
ITERATION 46
============================================================
Room: Paved Road (ID: 293)
Inventory: empty
Exits: none
Objects: none

AI analyzing...
Priority: medium
Suggested commands: ['north', 'look', 'examine', 'inventory']

> north


> look


> examine


> inventory


No interesting AI suggestions. Trying basic directions...

============================================================
ITERATION 47
============================================================
Room: Paved Road (ID: 293)
Inventory: empty
Exits: none
Objects: none

AI analyzing...
Priority: medium
Suggested commands: ['look', 'examine', 'inventory', 'search', 'north']

> look


> examine


> inventory


> search


> north


No interesting AI suggestions. Trying basic directions...

============================================================
ITERATION 48
============================================================
Room: Paved Road (ID: 293)
Inventory: empty
Exits: none
Objects: none

AI analyzing...
Priority: medium
Suggested commands: ['examine', 'look', 'inventory', 'n', 's', 'e', 'w']

> examine


> look


> inventory


> n


> s


No interesting AI suggestions. Trying basic directions...

============================================================
ITERATION 49
============================================================
Room: Paved Road (ID: 293)
Inventory: empty
Exits: none
Objects: none

AI analyzing...
Priority: medium
Suggested commands: ['n', 's', 'e', 'w', 'inventory', 'examine']

> n


> s


> e


> w


> inventory


No interesting AI suggestions. Trying basic directions...

============================================================
ITERATION 50
============================================================
Room: Paved Road (ID: 293)
Inventory: empty
Exits: none
Objects: none

AI analyzing...
Priority: medium
Suggested commands: ['examine', 'look around', 'inventory', 'help', 'north']

> examine


> look around


> inventory


> help


> north


No interesting AI suggestions. Trying basic directions...

============================================================
SOLUTION SUMMARY
============================================================
Rooms discovered: 1
Commands in solution: 0

Solution path:

✓ Solution saved to: trinity_solution.json

✓ Walkthrough generated: trinity_solution.json
  Rooms visited: 1
  Commands: 0

STEP 2: Compiling with z2js...
----------------------------------------------------------------------
  Compiling trinity with z2js...
  ✓ Generated z2js_output/trinity.js (473,630 bytes)

======================================================================
GAME 5/5: Curses (Classic IF)
File: games/zcode/curses.z5
======================================================================

STEP 1: Generating walkthrough with AI...
----------------------------------------------------------------------
Loading games/zcode/curses.z5...
============================================================
GAME START
============================================================













                              Welcome to CURSES


                        [Please press SPACE to begin.]
                                                                      Curses are like young chickens,                                   they always come home to roost.                                                                      -- Robert Southey (1774-1843),                                      "The Curse of Kehama"                                   [ Curses are like young chickens,
  they always come home to roost.
  
  -- Robert Southey (1774-1843),
     "The Curse of Kehama"]



Using Anthropic Claude for AI assistance...

============================================================
ITERATION 1
============================================================
Room: Welcome to CURSES (ID: 1)
Inventory: empty
Exits: none
Objects: none

AI analyzing...
Priority: medium
Puzzles detected: ['The game may have some sort of curse or chicken-related theme or mechanic that the player needs to uncover or solve.']
Suggested commands: ['look', 'examine description', 'read', 'take', 'inventory']

> look


> examine description


> read


> take


> inventory


No interesting AI suggestions. Trying basic directions...

============================================================
ITERATION 2
============================================================
Room: Welcome to CURSES (ID: 1)
Inventory: empty
Exits: none
Objects: none

AI analyzing...
Priority: high
Puzzles detected: ["The nature of the 'curses' mentioned in the description may be a central puzzle or theme of the game."]
Suggested commands: ['look', 'examine', 'help', 'inventory', 'read']

> look


> examine


> help


> inventory


> read


No interesting AI suggestions. Trying basic directions...

============================================================
ITERATION 3
============================================================
Room: Welcome to CURSES (ID: 1)
Inventory: empty
Exits: none
Objects: none

AI analyzing...
Priority: high
Suggested commands: ['look', 'examine', 'take inventory', 'read', 'help']

> look


> examine


> take inventory


> read


> help


No interesting AI suggestions. Trying basic directions...

============================================================
ITERATION 4
============================================================
Room: Welcome to CURSES (ID: 1)
Inventory: empty
Exits: none
Objects: none

AI analyzing...
Priority: high
Suggested commands: ['look', 'examine', 'inventory', 'take', 'go']

> look


> examine


> inventory


> take


> go


No interesting AI suggestions. Trying basic directions...

============================================================
ITERATION 5
============================================================
Room: Welcome to CURSES (ID: 1)
Inventory: empty
Exits: none
Objects: none

AI analyzing...
Priority: high
Puzzles detected: ['The game may require the player to understand or solve the meaning of the quote about curses to progress further.']
Suggested commands: ['look', 'examine', 'take', 'read', 'go']

> look


> examine


> take


> read


> go


No interesting AI suggestions. Trying basic directions...

============================================================
ITERATION 6
============================================================
Room: Welcome to CURSES (ID: 1)
Inventory: empty
Exits: none
Objects: none

AI analyzing...
Priority: high
Suggested commands: ['look', 'examine', 'take', 'inventory', 'help']

> look


> examine


> take


> inventory


> help


No interesting AI suggestions. Trying basic directions...

============================================================
ITERATION 7
============================================================
Room: Welcome to CURSES (ID: 1)
Inventory: empty
Exits: none
Objects: none

AI analyzing...
Priority: high
Puzzles detected: ['The quote suggests there may be a curse or other challenge the player will need to overcome.']
Suggested commands: ['look', 'examine', 'read', 'take', 'inventory']

> look


> examine


> read


> take


> inventory


No interesting AI suggestions. Trying basic directions...

============================================================
ITERATION 8
============================================================
Room: Welcome to CURSES (ID: 1)
Inventory: empty
Exits: none
Objects: none

AI analyzing...
Priority: medium
Suggested commands: ['examine', 'look', 'inventory', 'read', 'help']

> examine


> look


> inventory


> read


> help


No interesting AI suggestions. Trying basic directions...

============================================================
ITERATION 9
============================================================
Room: Welcome to CURSES (ID: 1)
Inventory: empty
Exits: none
Objects: none

AI analyzing...
Priority: high
Suggested commands: ['look', 'examine', 'take', 'go north', 'go south']

> look


> examine


> take


> go north


> go south


No interesting AI suggestions. Trying basic directions...

============================================================
ITERATION 10
============================================================
Room: Welcome to CURSES (ID: 1)
Inventory: empty
Exits: none
Objects: none

AI analyzing...
Priority: high
Puzzles detected: ['There is no apparent puzzle yet, but the game may require the player to explore further to find one.']
Suggested commands: ['look', 'examine', 'read', 'go north', 'take']

> look


> examine


> read


> go north


> take


No interesting AI suggestions. Trying basic directions...

============================================================
ITERATION 11
============================================================
Room: Welcome to CURSES (ID: 1)
Inventory: empty
Exits: none
Objects: none

AI analyzing...
Priority: high
Puzzles detected: ['There is no apparent puzzle yet, as the game has just started.']
Suggested commands: ['look', 'examine', 'read', 'take', 'inventory']

> look


> examine


> read


> take


> inventory


No interesting AI suggestions. Trying basic directions...

============================================================
ITERATION 12
============================================================
Room: Welcome to CURSES (ID: 1)
Inventory: empty
Exits: none
Objects: none

AI analyzing...
Priority: high
Puzzles detected: ['The quote about curses and chickens may be a clue or hint about a larger puzzle or theme in the game.']
Suggested commands: ['look', 'examine', 'take', 'inventory', 'read']

> look


> examine


> take


> inventory


> read


No interesting AI suggestions. Trying basic directions...

============================================================
ITERATION 13
============================================================
Room: Welcome to CURSES (ID: 1)
Inventory: empty
Exits: none
Objects: none

AI analyzing...
Priority: medium
Suggested commands: ['look', 'inventory', 'examine room']

> look


> inventory


> examine room


No interesting AI suggestions. Trying basic directions...

============================================================
ITERATION 14
============================================================
Room: Welcome to CURSES (ID: 1)
Inventory: empty
Exits: none
Objects: none

AI analyzing...
Priority: high
Suggested commands: ['look', 'examine', 'take', 'inventory', 'north']

> look


> examine


> take


> inventory


> north


No interesting AI suggestions. Trying basic directions...

============================================================
ITERATION 15
============================================================
Room: Welcome to CURSES (ID: 1)
Inventory: empty
Exits: none
Objects: none

AI analyzing...
Priority: high
Puzzles detected: ["The game may involve solving a curse or mystery related to the quote from 'The Curse of Kehama'"]
Suggested commands: ['look', 'examine', 'take', 'read', 'talk']

> look


> examine


> take


> read


> talk


No interesting AI suggestions. Trying basic directions...

============================================================
ITERATION 16
============================================================
Room: Welcome to CURSES (ID: 1)
Inventory: empty
Exits: none
Objects: none

AI analyzing...
Priority: high
Suggested commands: ['look', 'examine', 'take', 'inventory', 'north']

> look


> examine


> take


> inventory


> north


No interesting AI suggestions. Trying basic directions...

============================================================
ITERATION 17
============================================================
Room: Welcome to CURSES (ID: 1)
Inventory: empty
Exits: none
Objects: none

AI analyzing...
Priority: high
Puzzles detected: ['The game may involve solving a curse or overcoming some kind of challenge based on the opening text.']
Suggested commands: ['look', 'examine', 'take', 'read', 'help']

> look


> examine


> take


> read


> help


No interesting AI suggestions. Trying basic directions...

============================================================
ITERATION 18
============================================================
Room: Welcome to CURSES (ID: 1)
Inventory: empty
Exits: none
Objects: none

AI analyzing...
Priority: high
Puzzles detected: ['None apparent yet']
Suggested commands: ['look', 'examine room', 'examine description', 'read', 'inventory']

> look


> examine room


> examine description


> read


> inventory


No interesting AI suggestions. Trying basic directions...

============================================================
ITERATION 19
============================================================
Room: Welcome to CURSES (ID: 1)
Inventory: empty
Exits: none
Objects: none

AI analyzing...
Priority: high
Puzzles detected: ["The description mentions 'curses' and 'chickens', which could be hints at some kind of curse or chicken-related puzzle the player will need to solve."]
Suggested commands: ['look', 'examine', 'read', 'take', 'inventory']

> look


> examine


> read


> take


> inventory


No interesting AI suggestions. Trying basic directions...

============================================================
ITERATION 20
============================================================
Room: Welcome to CURSES (ID: 1)
Inventory: empty
Exits: none
Objects: none

AI analyzing...
Priority: high
Suggested commands: ['examine', 'look around', 'take inventory', 'north', 'south', 'east', 'west']

> examine


> look around


> take inventory


> north


> south


No interesting AI suggestions. Trying basic directions...

============================================================
ITERATION 21
============================================================
Room: Welcome to CURSES (ID: 1)
Inventory: empty
Exits: none
Objects: none

AI analyzing...
Priority: high
Puzzles detected: ['The game may involve solving a curse or other mystery, as hinted by the title and the quote in the description.']
Suggested commands: ['look', 'examine room', 'examine description', 'read', 'take']

> look


> examine room


> examine description


> read


> take


No interesting AI suggestions. Trying basic directions...

============================================================
ITERATION 22
============================================================
Room: Welcome to CURSES (ID: 1)
Inventory: empty
Exits: none
Objects: none

AI analyzing...
Priority: medium
Puzzles detected: ['There are no obvious puzzles or obstacles at this stage, but the game may introduce challenges or tasks later on.']
Suggested commands: ['look', 'examine', 'read', 'help', 'inventory']

> look


> examine


> read


> help


> inventory


No interesting AI suggestions. Trying basic directions...

============================================================
ITERATION 23
============================================================
Room: Welcome to CURSES (ID: 1)
Inventory: empty
Exits: none
Objects: none

AI analyzing...
Priority: high
Puzzles detected: ['There are no apparent puzzles or obstacles in this initial room.']
Suggested commands: ['look', 'examine', 'take', 'inventory', 'north']

> look


> examine


> take


> inventory


> north


No interesting AI suggestions. Trying basic directions...

============================================================
ITERATION 24
============================================================
Room: Welcome to CURSES (ID: 1)
Inventory: empty
Exits: none
Objects: none

AI analyzing...
Priority: high
Suggested commands: ['look', 'examine', 'take', 'talk']

> look


> examine


> take


> talk


No interesting AI suggestions. Trying basic directions...

============================================================
ITERATION 25
============================================================
Room: Welcome to CURSES (ID: 1)
Inventory: empty
Exits: none
Objects: none

AI analyzing...
Priority: high
Suggested commands: ['look', 'examine', 'inventory', 'help']

> look


> examine


> inventory


> help


No interesting AI suggestions. Trying basic directions...

============================================================
ITERATION 26
============================================================
Room: Welcome to CURSES (ID: 1)
Inventory: empty
Exits: none
Objects: none

AI analyzing...
Priority: medium
Puzzles detected: ['none apparent yet']
Suggested commands: ['look', 'examine room', 'examine description', 'examine objects', 'inventory']

> look


> examine room


> examine description


> examine objects


> inventory


No interesting AI suggestions. Trying basic directions...

============================================================
ITERATION 27
============================================================
Room: Welcome to CURSES (ID: 1)
Inventory: empty
Exits: none
Objects: none

AI analyzing...
Priority: high
Puzzles detected: ['There may be a puzzle or interaction required to progress beyond the starting room.']
Suggested commands: ['look', 'examine', 'inventory', 'take', 'read']

> look


> examine


> inventory


> take


> read


No interesting AI suggestions. Trying basic directions...

============================================================
ITERATION 28
============================================================
Room: Welcome to CURSES (ID: 1)
Inventory: empty
Exits: none
Objects: none

AI analyzing...
Priority: high
Suggested commands: ['look', 'examine', 'take', 'read', 'talk']

> look


> examine


> take


> read


> talk


No interesting AI suggestions. Trying basic directions...

============================================================
ITERATION 29
============================================================
Room: Welcome to CURSES (ID: 1)
Inventory: empty
Exits: none
Objects: none

AI analyzing...
Priority: high
Suggested commands: ['look', 'examine', 'take', 'inventory', 'north']

> look


> examine


> take


> inventory


> north


No interesting AI suggestions. Trying basic directions...

============================================================
ITERATION 30
============================================================
Room: Welcome to CURSES (ID: 1)
Inventory: empty
Exits: none
Objects: none

AI analyzing...
Priority: high
Suggested commands: ['look', 'examine', 'take', 'north', 'south']

> look


> examine


> take


> north


> south


No interesting AI suggestions. Trying basic directions...

============================================================
ITERATION 31
============================================================
Room: Welcome to CURSES (ID: 1)
Inventory: empty
Exits: none
Objects: none

AI analyzing...
Priority: medium
Suggested commands: ['look', 'inventory', 'examine room']

> look


> inventory


> examine room


No interesting AI suggestions. Trying basic directions...

============================================================
ITERATION 32
============================================================
Room: Welcome to CURSES (ID: 1)
Inventory: empty
Exits: none
Objects: none

AI analyzing...
Priority: high
Suggested commands: ['look', 'examine', 'take', 'inventory', 'help']

> look


> examine


> take


> inventory


> help


No interesting AI suggestions. Trying basic directions...

============================================================
ITERATION 33
============================================================
Room: Welcome to CURSES (ID: 1)
Inventory: empty
Exits: none
Objects: none

AI analyzing...
Priority: high
Puzzles detected: ['The game may require the player to find a way to start or progress the story from this initial room.']
Suggested commands: ['look', 'examine', 'take', 'read', 'start']

> look


> examine


> take


> read


> start


No interesting AI suggestions. Trying basic directions...

============================================================
ITERATION 34
============================================================
Room: Welcome to CURSES (ID: 1)
Inventory: empty
Exits: none
Objects: none

AI analyzing...
Priority: high
Puzzles detected: ['The game may involve breaking or dealing with curses, based on the theme and quotes.']
Suggested commands: ['look', 'examine room', 'examine description', 'examine quotes', 'read']

> look


> examine room


> examine description


> examine quotes


> read


No interesting AI suggestions. Trying basic directions...

============================================================
ITERATION 35
============================================================
Room: Welcome to CURSES (ID: 1)
Inventory: empty
Exits: none
Objects: none

AI analyzing...
Priority: medium
Puzzles detected: ["The description mentions 'curses' and a quote, which may hint at some kind of curse or mystery to unravel."]
Suggested commands: ['look', 'examine', 'read', 'take', 'go north']

> look


> examine


> read


> take


> go north


No interesting AI suggestions. Trying basic directions...

============================================================
ITERATION 36
============================================================
Room: Welcome to CURSES (ID: 1)
Inventory: empty
Exits: none
Objects: none

AI analyzing...
Priority: medium
Suggested commands: ['look', 'examine', 'read', 'inventory', 'help']

> look


> examine


> read


> inventory


> help


No interesting AI suggestions. Trying basic directions...

============================================================
ITERATION 37
============================================================
Room: Welcome to CURSES (ID: 1)
Inventory: empty
Exits: none
Objects: none

AI analyzing...
Priority: high
Puzzles detected: ["The game may involve breaking a curse or exploring the concept of 'curses' mentioned in the room description."]
Suggested commands: ['look', 'examine', 'inventory', 'take', 'read']

> look


> examine


> inventory


> take


> read


No interesting AI suggestions. Trying basic directions...

============================================================
ITERATION 38
============================================================
Room: Welcome to CURSES (ID: 1)
Inventory: empty
Exits: none
Objects: none

AI analyzing...
Priority: medium
Suggested commands: ['look', 'examine', 'read', 'inventory', 'help']

> look


> examine


> read


> inventory


> help


No interesting AI suggestions. Trying basic directions...

============================================================
ITERATION 39
============================================================
Room: Welcome to CURSES (ID: 1)
Inventory: empty
Exits: none
Objects: none

AI analyzing...
Priority: high
Puzzles detected: ["The nature of the 'curses' mentioned in the quote and how they relate to the game"]
Suggested commands: ['look', 'examine', 'take', 'inventory', 'read']

> look


> examine


> take


> inventory


> read


No interesting AI suggestions. Trying basic directions...

============================================================
ITERATION 40
============================================================
Room: Welcome to CURSES (ID: 1)
Inventory: empty
Exits: none
Objects: none

AI analyzing...
Priority: high
Puzzles detected: ['The game may involve solving a curse-related puzzle based on the title and the quote.']
Suggested commands: ['look', 'examine', 'read', 'inventory', 'help']

> look


> examine


> read


> inventory


> help


No interesting AI suggestions. Trying basic directions...

============================================================
ITERATION 41
============================================================
Room: Welcome to CURSES (ID: 1)
Inventory: empty
Exits: none
Objects: none

AI analyzing...
Priority: high
Puzzles detected: ['The quote about curses coming home to roost may be a clue or hint about a central puzzle or theme of the game.']
Suggested commands: ['look', 'examine', 'take', 'inventory', 'read']

> look


> examine


> take


> inventory


> read


No interesting AI suggestions. Trying basic directions...

============================================================
ITERATION 42
============================================================
Room: Welcome to CURSES (ID: 1)
Inventory: empty
Exits: none
Objects: none

AI analyzing...
Priority: high
Puzzles detected: ['The game may require the player to press the space key to begin, indicating a potential puzzle or interaction to progress the game.']
Suggested commands: ['look', 'examine', 'read', 'take', 'inventory']

> look


> examine


> read


> take


> inventory


No interesting AI suggestions. Trying basic directions...

============================================================
ITERATION 43
============================================================
Room: Welcome to CURSES (ID: 1)
Inventory: empty
Exits: none
Objects: none

AI analyzing...
Priority: low
Puzzles detected: ['There are no apparent puzzles or obstacles in this introductory area. The player should focus on exploring and interacting with the environment to progress further in the game.']
Suggested commands: ['look', 'examine', 'get', 'take', 'read']

> look


> examine


> get


> take


> read


No interesting AI suggestions. Trying basic directions...

============================================================
ITERATION 44
============================================================
Room: Welcome to CURSES (ID: 1)
Inventory: empty
Exits: none
Objects: none

AI analyzing...
Priority: high
Puzzles detected: ['The game may involve breaking or dealing with curses, based on the introductory text.']
Suggested commands: ['look', 'examine', 'read', 'go north', 'take']

> look


> examine


> read


> go north


> take


No interesting AI suggestions. Trying basic directions...

============================================================
ITERATION 45
============================================================
Room: Welcome to CURSES (ID: 1)
Inventory: empty
Exits: none
Objects: none

AI analyzing...
Priority: high
Suggested commands: ['look', 'examine', 'take', 'north', 'south']

> look


> examine


> take


> north


> south


No interesting AI suggestions. Trying basic directions...

============================================================
ITERATION 46
============================================================
Room: Welcome to CURSES (ID: 1)
Inventory: empty
Exits: none
Objects: none

AI analyzing...
Priority: high
Puzzles detected: ["The game may involve breaking or resolving a curse, based on the room description and the quote from 'The Curse of Kehama'."]
Suggested commands: ['look', 'examine', 'read', 'take', 'inventory']

> look


> examine


> read


> take


> inventory


No interesting AI suggestions. Trying basic directions...

============================================================
ITERATION 47
============================================================
Room: Welcome to CURSES (ID: 1)
Inventory: empty
Exits: none
Objects: none

AI analyzing...
Priority: high
Puzzles detected: ['No puzzles or obstacles are apparent at this stage.']
Suggested commands: ['look', 'examine room', 'examine description', 'examine vocabulary', 'take inventory']

> look


> examine room


> examine description


> examine vocabulary


> take inventory


No interesting AI suggestions. Trying basic directions...

============================================================
ITERATION 48
============================================================
Room: Welcome to CURSES (ID: 1)
Inventory: empty
Exits: none
Objects: none

AI analyzing...
Priority: high
Suggested commands: ['look', 'examine', 'inventory', 'read']

> look


> examine


> inventory


> read


No interesting AI suggestions. Trying basic directions...

============================================================
ITERATION 49
============================================================
Room: Welcome to CURSES (ID: 1)
Inventory: empty
Exits: none
Objects: none

AI analyzing...
Priority: medium
Puzzles detected: ['The game may start once the player presses the space bar, indicating a potential puzzle or challenge to overcome.']
Suggested commands: ['look', 'examine', 'read', 'start', 'inventory']

> look


> examine


> read


> start


> inventory


No interesting AI suggestions. Trying basic directions...

============================================================
ITERATION 50
============================================================
Room: Welcome to CURSES (ID: 1)
Inventory: empty
Exits: none
Objects: none

AI analyzing...
Priority: high
Puzzles detected: ['The game may involve solving a curse or breaking a spell, based on the title and theme.']
Suggested commands: ['look', 'examine', 'take', 'inventory', 'read']

> look


> examine


> take


> inventory


> read


No interesting AI suggestions. Trying basic directions...

============================================================
SOLUTION SUMMARY
============================================================
Rooms discovered: 1
Commands in solution: 0

Solution path:

✓ Solution saved to: curses_solution.json

✓ Walkthrough generated: curses_solution.json
  Rooms visited: 1
  Commands: 0

STEP 2: Compiling with z2js...
----------------------------------------------------------------------
  Compiling curses with z2js...
  ✓ Generated z2js_output/curses.js (470,078 bytes)


======================================================================
FINAL SUMMARY
======================================================================

1. Anchorhead
   Status: walkthrough_generated
   Rooms: 1, Commands: 174
   Z2JS: compiled

2. Photopia
   Status: walkthrough_generated
   Rooms: 2, Commands: 4
   Z2JS: compiled

3. Lost Pig
   Status: walkthrough_generated
   Rooms: 2, Commands: 123
   Z2JS: compiled

4. Trinity
   Status: walkthrough_generated
   Rooms: 1, Commands: 0
   Z2JS: compiled

5. Curses
   Status: walkthrough_generated
   Rooms: 1, Commands: 0
   Z2JS: compiled

Walkthroughs generated: 5/5
Z2JS compilations: 5/5

Results saved to: top5_progress.json
